formula = expression 
  
 expression= refExpression / whitespace* nospaceExpression whitespace*
 refExpression= whitespace* refNospaceExpression whitespace*
 nospaceExpression = "("  expression  ")" / constant / prefixOperator expression / expression infixOperator expression / expression postfixOperator / functionCall
 refNospaceExpression = "("  refExpression  ")" / refConstant / refExpression refInfixOperator refExpression / cellReference / refFunctionCall / nameReference / structureReference
 constant = errorConstant / logicalConstant / numericalConstant / stringConstant / arrayConstant
 refConstant = "#REF!"
 errorConstant = refConstant / "#DIV/0!"  /  "#N/A"  /  "#NAME?"  /  "#NULL!" / "#NUM!"  / "#VALUE!" / "#GETTING_DATA"
 logicalConstant = "FALSE"  /  "TRUE"
 numericalConstant = negSign? significandPart exponentPart?
 significandPart = wholeNumberPart fractionalPart? / fractionalPpart
 wholeNumberPart = digitSequence
 fractionalPart = fullStop digitSequence
 exponentPart = exponentCharacter sign? digitSequence
 fullStop = "."
 sign = "+"  / negSign
 negSign = "-"
 exponentCharacter = "E"
 digitSequence = decimalDigit+
 decimalDigit=  [\u0030-\u0039]
 nonzeroDecimalDigit = [\u0031-\u0039]
 stringConstant = doubleQuote stringChars? doubleQuote
 stringChars = stringChar stringChar*
 stringChar = escapedDoubleQuote / character /*MUST NOT be a double-quote*/
 escapedDoubleQuote = (doubleQuote doubleQuote)
 doubleQuote = [\u0022]
 /*;character = as defined by the production Char in the [W3C-XML] section 2.2*/
 arrayConstant = "{" constantListRows "}"
 constantListRows =  constantListRow *(semicolon  constantListRow)
 semicolon =  ";"
 constantListRow = constant (comma constant)*
 /*;An array-constant MUST NOT contain an array-constant or columns of unequal length or rows of unequal length.*/
 operator = ":" / comma / space / "^" / "*" / "/" / "+" / "-" / "&" / "=" / "<>" / "<" / "<=" / ">" / ">=" / "%"  
 infixOperator = refInfixOperator / valueInfixOperator
 valueInfixOperator = "^" / "*" / "/" / "+" / "-" / "&"/ "=" / "<>" / "<" / "<=" / ">" / ">="
 refInfixOperator = rangeOperator / unionOperator / intersectionOperator
 unionOperator = comma
 intersectionOperator = space
 rangeOperator = ":"
 postfixOperator =  "%"
 prefixOperator =  "+"  /  "-"
 cellReference = externalCellReference / localCellReference
 localCellReference = A1Reference
 externalCellReference = bangReference / sheetRangeReference / singleSheetReference
 bookPrefix = workbookIndex "!"
 bangReference = "!" (A1Reference / "#REF!")
 sheetRangeReference = sheetRange "!" A1Reference
 singleSheetPrefix = singleSheet "!"
 singleSheetReference = singleSheetPrefix (A1Reference / "#REF!")
 singleSheetArea = singleSheetPrefix A1Area
 singleSheet = workbookIndex? sheetName / apostrophe workbookIndex? sheetNameSpecial apostrophe
 sheetRange = workbookIndex? sheetName ":" sheetName / apostrophe workbookIndex? sheetNameSpecial ":" sheetNameSpecial apostrophe
 workbookIndex = "[" wholeNumberPart "]"
 sheetName = sheetNameCharacters
 sheetNameCharacters = sheetNameCharacter+
 sheetNameCharacter = character /*; MUST NOT be an operator, ', [, ], \, or ?*/
 apostrophe= "'"
 space = " " 
 whitespace = space / [\u000D] [\u000A]
 sheetNameSpecial = sheetNameBaseCharacter  (sheetNameCharacterSpecial* sheetNameBaseCharacter)?
 sheetNameCharacterSpecial = (apostrophe apostrophe) / sheetNameBaseCharacter
 sheetNameBaseCharacter = character /*; MUST NOT be ', *, [, ], \, :, /, ?, or Unicode character ‘END OF TEXT’*/
 A1Reference = (A1Column ":" A1Column) / (A1Row ":" A1Row) / A1Cell / A1Area
 A1Cell = A1Column A1Row
 A1Area = A1Cell ":" A1Cell
 A1Column = A1RelativeColumn / A1AbsoluteColumn
 A1RelativeColumn = (letter letter?) / AtoW letter letter / "X" AtoE letter / "XF" AtoD
 AtoD = [\u0041-\u0044] / [\u0061-\u0064]
 AtoE = AtoD / "E"
 AtoW = [\u0041-\u0057] / [\u0061-\u0077]
 letter = [\u0041-\u005A] / [\u0061-\u007A]
 A1AbsoluteColumn = "$" A1RelativeColumn
 A1Row = A1RelativeRow / A1AbsoluteRow
 A1RelativeRow = rowDigitSequence
 rowDigitSequence = nonzeroDecimalDigit (decimalDigit decimalDigit decimalDigit decimalDigit decimalDigit)? /  "10" [\u0030-\u0033] (decimalDigit decimalDigit decimalDigit decimalDigit) / "104" [\u0030-\u0037] (decimalDigit decimalDigit decimalDigit) / "1048" [\u0030-\u0034] (decimalDigit decimalDigit) / "10485" [\u0030-\u0036] decimalDigit / "104857" [\u0030-\u0036]
 A1AbsoluteRow = "$" A1RelativeRow
 cellFunctionCall = A1Cell "(" argumentList ")"
 userDefinedFunctionCall = userDefinedFunctionName "(" argumentList ")"
 userDefinedFunctionName = nameReference
 argumentList = argument (comma argument)*
 comma= ","
 argument = whitespace* argumentExpression?
 argumentExpression= refArgumentExpression / whitespace* nospaceArgumentExpression whitespace*
 refArgumentExpression= whitespace* refArgumentNospaceExpression whitespace*
 nospaceArgumentExpression = "("  expression  ")" / constant / prefixOperator argumentExpression / argumentExpression argumentInfixOperator argumentExpression / argumentExpression postfixOperator / functionCall
 refArgumentNospaceExpression = "("  refExpression  ")" / refConstant / refArgumentExpression refArgumentInfixOperator refArgumentExpression / cellReference / refFunctionCall / nameReference / structureReference
 argumentInfixOperator = refArgumentInfixOperator / valueInfixOperator
  
 refArgumentInfixOperator = rangeOperator / intersectionOperator
 /*unicode-digit = (any code points which are digits as defined by the Unicode character properties, [UNICODE5.1] chapter 4)*/
 /*R1C1CellReference = R1C1Row / R1C1Column / R1C1Row R1C1Column / R1C1Column R1C1Row
 R1C1Row = "R" rowNumber

 R1C1Column = "C" columnNumber
 columnNumber = [1-16384]
 ; A string composed of unicode-digits that represents an unsigned integer that is greater than or equal to 1 and less than or equal to 16384
  
 rowNumber = 1-1048576
 ; A string composed of unicode-digits that represents an unsigned integer that is greater than or equal to 1 and less than or equal to 1048576.*/
  
 nameReference = name / externalName
 externalName = bangName / (singleSheetPrefix / bookPrefix ) name
 bangName = "!" name
 name = nameStartCharacter nameCharacters?
 nameStartCharacter = underscore  /  backslash  /  letter / nameBaseCharacter
 underscore = "_"  
 backslash = "\" 
 nameBaseCharacter = (any code points which are characters as defined by the Unicode character properties, [UNICODE5.1] chapter 4 ; MUST NOT be 0x0-0x7F)
 nameCharacters= nameCharacter+
 nameCharacter = nameStartCharacter / decimalDigit / fullStop  / questionmark
 questionmark = "?" 
 /*;A name MUST NOT have any of the following forms:
 ;TRUE or FALSE
 ;cellReference
 ;functionList
 ;commandList
 ;futureFunctionList
 ;R1C1-cellReference*/
  
 structureReference = tableIdentifier? intraTableReference
 tableIdentifier = bookPrefix? tableName
 tableName = name
 /*;tableName is the name of the table the structure reference refers to. If it is missing, the formula containing the structure reference MUST be entered into a cell
   which belongs to a table and that table’s name is used as the tableName. tableName MUST be the value of the displayName attribute of some table element ([ISO/IEC29500-1:2011] section 18.5.1.2).
   It MUST NOT be any other user-defined name.*/
 intraTableReference = spacedLbracket innerReference spacedRbracket / keyword / ("[" simpleColumnName? "]")
 innerReference = keywordList / ((keywordList spacedComma)? columnRange)
 keywordList = keyword / ("[#Headers]" spacedComma "[#Data]") / ("[#Data]" spacedComma "[#Totals]")
 keyword = "[#All]" / "[#Data]" / "[#Headers]" / "[#Totals]" / "[#This Row]"
 columnRange = column (":" column)?
 column = simpleColumnName / ("[" space* simpleColumnName space* "]")
 simpleColumnName = (anyNospaceColumnCharacter anyColumnCharacter*)? anyNospaceColumnCharacter
 escapeColumnCharacter = tick / "[" / "]" / "#"
 tick = [\u0027]
 unescapedColumnCharacter = character   /*; MUST NOT match escapeColumnCharacter or space*/
 anyColumnCharacter = anyNospaceColumnCharacter / space
 anyNospaceColumnCharacter = unescapedColumnCharacter / (tick escapeColumnCharacter)
 spacedComma = space? comma space?
 spacedLbracket = "[" space?
 spacedRbracket = space? "]"
 
 functionList = "ABS" / "ABSREF" / "ACCRINT" / "ACCRINTM" / "ACOS" / "ACOSH" / "ACTIVE.CELL" / "ADD.BAR" / "ADD.COMMAND" / "ADD.MENU" / "ADD.TOOLBAR" / "ADDRESS" / "AMORDEGRC" / "AMORLINC" / "AND" / "APP.TITLE" / "AREAS" / "ARGUMENT" / "ASC" / "ASIN" / "ASINH" / "ATAN" / "ATAN2" / "ATANH" / "AVEDEV" / "AVERAGE" / "AVERAGEA" / "AVERAGEIF" / "AVERAGEIFS" / "BAHTTEXT" / "BESSELI" / "BESSELJ" / "BESSELK" / "BESSELY" / "BETADIST" / "BETAINV" / "BIN2DEC" / "BIN2HEX" / "BIN2OCT" / "BINOMDIST" / "BREAK" / "CALL" / "CALLER" / "CANCEL.KEY" / "CEILING" / "CELL" / "CHAR" / "CHECK.COMMAND" / "CHIDIST" / "CHIINV" / "CHITEST" / "CHOOSE" / "CLEAN" / "CODE" / "COLUMN" / "COLUMNS" / "COMBIN" / "COMPLEX" / "CONCATENATE" / "CONFIDENCE" / "CONVERT" / "CORREL" / "COS" / "COSH" / "COUNT" / "COUNTA" / "COUNTBLANK" / "COUNTIF" / "COUNTIFS" / "COUPDAYBS" / "COUPDAYS" / "COUPDAYSNC" / "COUPNCD" / "COUPNUM" / "COUPPCD" / "COVAR" / "CREATE.OBJECT" / "CRITBINOM" / "CUBEKPIMEMBER" / "CUBEMEMBER" / "CUBEMEMBERPROPERTY" / "CUBERANKEDMEMBER" / "CUBESET" / "CUBESETCOUNT" / "CUBEVALUE" / "CUMIPMT" / "CUMPRINC" / "CUSTOM.REPEAT" / "CUSTOM.UNDO" / "DATE" / "DATEDIF" / "DATESTRING" / "DATEVALUE" / "DAVERAGE" / "DAY" / "DAYS360" / "DB" / "DBCS" / "DCOUNT" / "DCOUNTA" / "DDB" / "DEC2BIN" / "DEC2HEX" / "DEC2OCT" / "DEGREES" / "DELETE.BAR" / "DELETE.COMMAND" / "DELETE.MENU" / "DELETE.TOOLBAR" / "DELTA" / "DEREF" / "DEVSQ" / "DGET" / "DIALOG.BOX" / "DIRECTORY" / "DISC" / "DMAX" / "DMIN" / "DOCUMENTS" / "DOLLAR" / "DOLLARDE" / "DOLLARFR" / "DPRODUCT" / "DSTDEV" / "DSTDEVP" / "DSUM" / "DURATION" / "DVAR" / "DVARP" / "ECHO" / "EDATE" / "EFFECT" / "ELSE" / "ELSE.IF" / "ENABLE.COMMAND" / "ENABLE.TOOL" / "END.IF" / "EOMONTH" / "ERF" / "ERFC" / "ERROR" / "ERROR.TYPE" / "EVALUATE" / "EVEN" / "EXACT" / "EXEC" / "EXECUTE" / "EXP" / "EXPONDIST" / "FACT" / "FACTDOUBLE" / "FALSE" / "FCLOSE" / "FDIST" / "FILES" / "FIND" / "FINDB" / "FINV" / "FISHER" / "FISHERINV" / "FIXED" / "FLOOR" / "FOPEN" / "FOR" / "FOR.CELL" / "FORECAST" / "FORMULA.CONVERT" / "FPOS" / "FREAD" / "FREADLN" / "FREQUENCY" / "FSIZE" / "FTEST" / "FV" / "FVSCHEDULE" / "FWRITE" / "FWRITELN" / "GAMMADIST" / "GAMMAINV" / "GAMMALN" / "GCD" / "GEOMEAN" / "GESTEP" / "GET.BAR" / "GET.CELL" / "GET.CHART.ITEM" / "GET.DEF" / "GET.DOCUMENT" / "GET.FIELD" / "GET.FORMULA" / "GET.ITEM" / "GET.LINK.INFO" / "GET.MOVIE" / "GET.NAME" / "GET.NOTE" / "GET.OBJECT" / "GET.TOOL" / "GET.TOOLBAR" / "GET.VIEW" / "GET.WINDOW" / "GET.WORKBOOK" / "GET.WORKSPACE" / "GETPIVOTDATA" / "GOTO" / "GROUP" / "GROWTH" / "HALT" / "HARMEAN" / "HELP" / "HEX2BIN" / "HEX2DEC" / "HEX2OCT" / "HLOOKUP" / "HOUR" / "HYPERLINK" / "HYPGEOMDIST" / "IF" / "IFERROR" / "IMABS" / "IMAGINARY" / "IMARGUMENT" / "IMCONJUGATE" / "IMCOS" / "IMDIV" / "IMEXP" / "IMLN" / "IMLOG10" / "IMLOG2" / "IMPOWER" / "IMPRODUCT" / "IMREAL" / "IMSIN" / "IMSQRT" / "IMSUB" / "IMSUM" / "INDEX" / "INDIRECT" / "INFO" / "INITIATE" / "INPUT" / "INT" / "INTERCEPT" / "INTRATE" / "IPMT" / "IRR" / "ISBLANK" / "ISERR" / "ISERROR" / "ISEVEN" / "ISLOGICAL" / "ISNA" / "ISNONTEXT" / "ISNUMBER" / "ISODD" / "ISPMT" / "ISREF" / "ISTEXT" / "ISTHAIDIGIT" / "KURT" / "LARGE" / "LAST.ERROR" / "LCM" / "LEFT" / "LEFTB" / "LEN" / "LENB" / "LINEST" / "LINKS" / "LN" / "LOG" / "LOG10" / "LOGEST" / "LOGINV" / "LOGNORMDIST" / "LOOKUP" / "LOWER" / "MATCH" / "MAX" / "MAXA" / "MDETERM" / "MDURATION" / "MEDIAN" / "MID" / "MIDB" / "MIN" / "MINA" / "MINUTE" / "MINVERSE" / "MIRR" / "MMULT" / "MOD" / "MODE" / "MONTH" / "MOVIE.COMMAND" / "MROUND" / "MULTINOMIAL" / "N" / "NA" / "NAMES" / "NEGBINOMDIST" / "NETWORKDAYS" / "NEXT" / "NOMINAL" / "NORMDIST" / "NORMINV" / "NORMSDIST" / "NORMSINV" / "NOT" / "NOTE" / "NOW" / "NPER" / "NPV" / "NUMBERSTRING" / "OCT2BIN" / "OCT2DEC" / "OCT2HEX" / "ODD" / "ODDFPRICE" / "ODDFYIELD" / "ODDLPRICE" / "ODDLYIELD" / "OFFSET" / "OPEN.DIALOG" / "OPTIONS.LISTS.GET" / "OR" / "PAUSE" / "PEARSON" / "PERCENTILE" / "PERCENTRANK" / "PERMUT" / "PHONETIC" / "PI" / "PMT" / "POISSON" / "POKE" / "POWER" / "PPMT" / "PRESS.TOOL" / "PRICE" / "PRICEDISC" / "PRICEMAT" / "PROB" / "PRODUCT" / "PROPER" / "PV" / "QUARTILE" / "QUOTIENT" / "RADIANS" / "RAND" / "RANDBETWEEN" / "RANK" / "RATE" / "RECEIVED" / "REFTEXT" / "REGISTER" / "REGISTER.ID" / "RELREF" / "RENAME.COMMAND" / "REPLACE" / "REPLACEB" / "REPT" / "REQUEST" / "RESET.TOOLBAR" / "RESTART" / "RESULT" / "RESUME" / "RETURN" / "RIGHT" / "RIGHTB" / "ROMAN" / "ROUND" / "ROUNDBAHTDOWN" / "ROUNDBAHTUP" / "ROUNDDOWN" / "ROUNDUP" / "ROW" / "ROWS" / "RSQ" / "RTD" / "SAVE.DIALOG" / "SAVE.TOOLBAR" / "SCENARIO.GET" / "SEARCH" / "SEARCHB" / "SECOND" / "SELECTION" / "SERIES" / "SERIESSUM" / "SET.NAME" / "SET.VALUE" / "SHOW.BAR" / "SIGN" / "SIN" / "SINH" / "SKEW" / "SLN" / "SLOPE" / "SMALL" / "SPELLING.CHECK" / "SPREADBASE.DATA.FIELD" / "SQRT" / "SQRTPI" / "STANDARDIZE" / "STDEV" / "STDEVA" / "STDEVP" / "STDEVPA" / "STEP" / "STEYX" / "SUBSTITUTE" / "SUBTOTAL" / "SUM" / "SUMIF" / "SUMIFS" / "SUMPRODUCT" / "SUMSQ" / "SUMX2MY2" / "SUMX2PY2" / "SUMXMY2" / "SYD" / "T" / "TAN" / "TANH" / "TBILLEQ" / "TBILLPRICE" / "TBILLYIELD" / "TDIST" / "TERMINATE" / "TEXT" / "TEXT.BOX" / "TEXTREF" / "THAIDAYOFWEEK" / "THAIDIGIT" / "THAIMONTHOFYEAR" / "THAINUMSOUND" / "THAINUMSTRING" / "THAISTRINGLENGTH" / "THAIYEAR" / "TIME" / "TIMEVALUE" / "TINV" / "TODAY" / "TRANSPOSE" / "TREND" / "TRIM" / "TRIMMEAN" / "TRUE" / "TRUNC" / "TTEST" / "TYPE" / "UNREGISTER" / "UPPER" / "USDOLLAR" / "VALUE" / "VAR" / "VARA" / "VARP" / "VARPA" / "VDB" / "VIEW.GET" / "VLOOKUP" / "VOLATILE" / "WEEKDAY" / "WEEKNUM" / "WEIBULL" / "WHILE" / "WINDOW.TITLE" / "WINDOWS" / "WORKDAY" / "XIRR" / "XNPV" / "YEAR" / "YEARFRAC" / "YIELD" / "YIELDDISC" / "YIELDMAT" / "ZTEST"
 commandList = ("A1.R1C1" / "ACTIVATE" / "ACTIVATE.NEXT" / "ACTIVATE.NOTES" / "ACTIVATE.PREV" / "ACTIVE.CELL.FONT" / "ADD.ARROW" / "ADD.CHART.AUTOFORMAT" / "ADD.LIST.ITEM" / "ADD.OVERLAY" / "ADD.PRINT.AREA" / "ADD.TOOL" / "ADDIN.MANAGER" / "ALERT" / "ALIGNMENT" / "APP.ACTIVATE" / "APP.ACTIVATE.MICROSOFT" / "APP.MAXIMIZE" / "APP.MINIMIZE" / "APP.MOVE" / "APP.RESTORE" / "APP.SIZE" / "APPLY.NAMES" / "APPLY.STYLE" / "ARRANGE.ALL" / "ASSIGN.TO.OBJECT" / "ASSIGN.TO.TOOL" / "ATTACH.TEXT" / "ATTACH.TOOLBARS" / "ATTRIBUTES" / "AUTO.OUTLINE" / "AUTOCORRECT" / "AXES" / "BEEP" / "BORDER" / "BRING.TO.FRONT" / "CALCULATE.DOCUMENT" / "CALCULATE.NOW" / "CALCULATION" / "CANCEL.COPY" / "CELL.PROTECTION" / "CHANGE.LINK" / "CHART.ADD.DATA" / "CHART.TREND" / "CHART.WIZARD" / "CHECKBOX.PROPERTIES" / "CLEAR" / "CLEAR.OUTLINE" / "CLEAR.PRINT.AREA" / "CLEAR.ROUTING.SLIP" / "CLOSE" / "CLOSE.ALL" / "COLOR.PALETTE" / "COLUMN.WIDTH" / "COMBINATION" / "CONSOLIDATE" / "CONSTRAIN.NUMERIC" / "COPY" / "COPY.CHART" / "COPY.PICTURE" / "COPY.TOOL" / "CREATE.NAMES" / "CREATE.PUBLISHER" / "CUSTOMIZE.TOOLBAR" / "CUT" / "DATA.DELETE" / "DATA.FIND" / "DATA.FIND.NEXT" / "DATA.FIND.PREV" / "DATA.FORM" / "DATA.LABEL" / "DATA.SERIES" / "DEFINE.NAME" / "DEFINE.STYLE" / "DELETE.ARROW" / "DELETE.CHART.AUTOFORMAT" / "DELETE.FORMAT" / "DELETE.NAME" / "DELETE.NOTE" / "DELETE.OVERLAY" / "DELETE.STYLE" / "DELETE.TOOL" / "DEMOTE" / "DISABLE.INPUT" / "DISPLAY" / "DUPLICATE" / "EDIT.COLOR" / "EDIT.DELETE" / "EDIT.OBJECT" / "EDIT.REPEAT" / "EDIT.SERIES" / "EDIT.TOOL" / "EDITBOX.PROPERTIES" / "EDITION.OPTIONS" / "ENABLE.OBJECT" / "ENABLE.TIPWIZARD" / "ENTER.DATA" / "ERRORBAR.X" / "ERRORBAR.Y" / "EXTEND.POLYGON" / "EXTRACT" / "FILE.CLOSE" / "FILE.DELETE" / "FILL.AUTO" / "FILL.DOWN" / "FILL.GROUP" / "FILL.LEFT" / "FILL.RIGHT" / "FILL.UP" / "FILTER" / "FILTER.ADVANCED" / "FILTER.SHOW.ALL" / "FIND.FILE" / "FONT" / "FONT.PROPERTIES" / "FORMAT.AUTO" / "FORMAT.CHART" / "FORMAT.CHARTTYPE" / "FORMAT.FONT" / "FORMAT.LEGEND" / "FORMAT.MAIN" / "FORMAT.MOVE" / "FORMAT.NUMBER" / "FORMAT.OVERLAY" / "FORMAT.SHAPE" / "FORMAT.SIZE" / "FORMAT.TEXT" / "FORMULA" / "FORMULA.ARRAY" / "FORMULA.FILL" / "FORMULA.FIND" / "FORMULA.FIND.NEXT" / "FORMULA.FIND.PREV" / "FORMULA.GOTO" / "FORMULA.REPLACE" / "FREEZE.PANES" / "FULL" / "FULL.SCREEN" / "FUNCTION.WIZARD" / "GALLERY.3D.AREA" / "GALLERY.3D.BAR" / "GALLERY.3D.COLUMN" / "GALLERY.3D.LINE" / "GALLERY.3D.PIE" / "GALLERY.3D.SURFACE" / "GALLERY.AREA" / "GALLERY.BAR" / "GALLERY.COLUMN" / "GALLERY.CUSTOM" / "GALLERY.DOUGHNUT" / "GALLERY.LINE" / "GALLERY.PIE" / "GALLERY.RADAR" / "GALLERY.SCATTER" / "GOAL.SEEK" / "GRIDLINES" / "HIDE" / "HIDE.DIALOG" / "HIDE.OBJECT" / "HIDEALL.INKANNOTS" / "HIDEALL.NOTES" / "HIDECURR.NOTE" / "HLINE" / "HPAGE" / "HSCROLL" / "INSERT" / "INSERT.MAP.OBJECT" / "INSERT.OBJECT" / "INSERT.PICTURE" / "INSERT.TITLE" / "INSERTDATATABLE" / "JUSTIFY" / "LABEL.PROPERTIES" / "LAYOUT" / "LEGEND" / "LINE.PRINT" / "LINK.COMBO" / "LINK.FORMAT" / "LIST.NAMES" / "LISTBOX.PROPERTIES" / "MACRO.OPTIONS" / "MAIL.ADD.MAILER" / "MAIL.DELETE.MAILER" / "MAIL.EDIT.MAILER" / "MAIL.FORWARD" / "MAIL.LOGOFF" / "MAIL.LOGON" / "MAIL.NEXT.LETTER" / "MAIL.REPLY" / "MAIL.REPLY.ALL" / "MAIL.SEND.MAILER" / "MAIN.CHART" / "MAIN.CHART.TYPE" / "MENU.EDITOR" / "MERGE.STYLES" / "MESSAGE" / "MOVE.BRK" / "MOVE.TOOL" / "MSOCHECKS" / "NEW" / "NEW.WINDOW" / "NEWWEBQUERY" / "NORMAL" / "OBJECT.PROPERTIES" / "OBJECT.PROTECTION" / "ON.DATA" / "ON.DOUBLECLICK" / "ON.ENTRY" / "ON.KEY" / "ON.RECALC" / "ON.SHEET" / "ON.TIME" / "ON.WINDOW" / "OPEN" / "OPEN.LINKS" / "OPEN.MAIL" / "OPEN.TEXT" / "OPTIONS.CALCULATION" / "OPTIONS.CHART" / "OPTIONS.EDIT" / "OPTIONS.GENERAL" / "OPTIONS.LISTS.ADD" / "OPTIONS.LISTS.DELETE" / "OPTIONS.ME" / "OPTIONS.MENONO" / "OPTIONS.SAVE" / "OPTIONS.SPELL" / "OPTIONS.TRANSITION" / "OPTIONS.VIEW" / "OUTLINE" / "OVERLAY" / "OVERLAY.CHART.TYPE" / "PAGE.SETUP" / "PARSE" / "PASTE" / "PASTE.LINK" / "PASTE.PICTURE" / "PASTE.PICTURE.LINK" / "PASTE.SPECIAL" / "PASTE.TOOL" / "PATTERNS" / "PICKLIST" / "PIVOT.ADD.FIELDS" / "PIVOT.FIELD" / "PIVOT.FIELD.GROUP" / "PIVOT.FIELD.PROPERTIES" / "PIVOT.FIELD.UNGROUP" / "PIVOT.ITEM" / "PIVOT.ITEM.PROPERTIES" / "PIVOT.REFRESH" / "PIVOT.SHOW.PAGES" / "PIVOT.TABLE.CHART" / "PIVOT.TABLE.WIZARD" / "POST.DOCUMENT" / "PRECISION" / "PREFERRED" / "PRINT" / "PRINT.PREVIEW" / "PRINTER.SETUP" / "PROMOTE" / "PROTECT.DOCUMENT" / "PROTECT.REVISIONS" / "PUSHBUTTON.PROPERTIES" / "QUIT" / "REMOVE.LIST.ITEM" / "REMOVE.PAGE.BREAK" / "RENAME.OBJECT" / "REPLACE.FONT" / "RESET.TOOL" / "RM.PRINT.AREA" / "ROUTE.DOCUMENT" / "ROUTING.SLIP" / "ROW.HEIGHT" / "RUN" / "SAVE" / "SAVE.AS" / "SAVE.COPY.AS" / "SAVE.NEW.OBJECT" / "SAVE.WORKBOOK" / "SAVE.WORKSPACE" / "SCALE" / "SCENARIO.ADD" / "SCENARIO.CELLS" / "SCENARIO.DELETE" / "SCENARIO.EDIT" / "SCENARIO.MERGE" / "SCENARIO.SHOW" / "SCENARIO.SHOW.NEXT" / "SCENARIO.SUMMARY" / "SCROLLBAR.PROPERTIES" / "SELECT" / "SELECT.ALL" / "SELECT.CHART" / "SELECT.END" / "SELECT.LAST.CELL" / "SELECT.LIST.ITEM" / "SELECT.PLOT.AREA" / "SELECT.SPECIAL" / "SEND.KEYS" / "SEND.MAIL" / "SEND.TO.BACK" / "SERIES.AXES" / "SERIES.ORDER" / "SERIES.X" / "SERIES.Y" / "SET.CONTROL.VALUE" / "SET.CRITERIA" / "SET.DATABASE" / "SET.DIALOG.DEFAULT" / "SET.DIALOG.FOCUS" / "SET.EXTRACT" / "SET.LIST.ITEM" / "SET.PAGE.BREAK" / "SET.PREFERRED" / "SET.PRINT.AREA" / "SET.PRINT.TITLES" / "SET.UPDATE.STATUS" / "SHARE" / "SHARE.NAME" / "SHEET.BACKGROUND" / "SHORT.MENUS" / "SHOW.ACTIVE.CELL" / "SHOW.CLIPBOARD" / "SHOW.DETAIL" / "SHOW.DIALOG" / "SHOW.INFO" / "SHOW.LEVELS" / "SHOW.TOOLBAR" / "SORT" / "SORT.SPECIAL" / "SOUND.NOTE" / "SOUND.PLAY" / "SPELLING" / "SPLIT" / "STANDARD.FONT" / "STANDARD.WIDTH" / "STYLE" / "SUBSCRIBE.TO" / "SUBTOTAL.CREATE" / "SUBTOTAL.REMOVE" / "SUMMARY.INFO" / "TAB.ORDER" / "TABLE" / "TEXT.TO.COLUMNS" / "TRACER.CLEAR" / "TRACER.DISPLAY" / "TRACER.ERROR" / "TRACER.NAVIGATE" / "TRAVERSE.NOTES" / "UNDO" / "UNGROUP" / "UNGROUP.SHEETS" / "UNHIDE" / "UNLOCKED.NEXT" / "UNLOCKED.PREV" / "UNPROTECT.REVISIONS" / "UPDATE.LINK" / "VBA.INSERT.FILE" / "VBA.MAKE.ADDIN" / "VBA.PROCEDURE.DEFINITION" / "VBAActivate" / "VIEW.3D" / "VIEW.DEFINE" / "VIEW.DELETE" / "VIEW.SHOW" / "VLINE" / "VPAGE" / "VSCROLL" / "WAIT" / "WEB.PUBLISH" / "WINDOW.MAXIMIZE" / "WINDOW.MINIMIZE" / "WINDOW.MOVE" / "WINDOW.RESTORE" / "WINDOW.SIZE" / "WORKBOOK.ACTIVATE" / "WORKBOOK.ADD" / "WORKBOOK.COPY" / "WORKBOOK.DELETE" / "WORKBOOK.HIDE" / "WORKBOOK.INSERT" / "WORKBOOK.MOVE" / "WORKBOOK.NAME" / "WORKBOOK.NEW" / "WORKBOOK.NEXT" / "WORKBOOK.OPTIONS" / "WORKBOOK.PREV" / "WORKBOOK.PROTECT" / "WORKBOOK.SCROLL" / "WORKBOOK.SELECT" / "WORKBOOK.TAB.SPLIT" / "WORKBOOK.UNHIDE" / "WORKGROUP" / "WORKGROUP.OPTIONS" / "WORKSPACE" / "ZOOM") "?"?
 futureFunctionList = ("_xlfn." ("AGGREGATE" / "ACOT" / "ACOTH" / "ARABIC" / "BASE" / "BETA.DIST" / "BETA.INV" / "BINOM.DIST" / "BINOM.DIST.RANGE" / "BINOM.INV" / "BITAND" / "BITLSHIFT" / "BITOR" / "BITRSHIFT" / "BITXOR" / "CEILING.MATH" / "CEILING.PRECISE" / "CHISQ.DIST" / "CHISQ.DIST.RT" / "CHISQ.INV" / "CHISQ.INV.RT" / "CHISQ.TEST" / "COMBINA" / "CONFIDENCE.NORM" / "CONFIDENCE.T" / "COT" / "COTH" / "COVARIANCE.P" / "COVARIANCE.S" / "CSC" / "CSCH" / "DAYS" / "DECIMAL" / "ERF.PRECISE" / "ERFC.PRECISE" / "EXPON.DIST" / "F.DIST" / "F.DIST.RT" / "F.INV" / "F.INV.RT" / "F.TEST" / "FILTERXML" / "FLOOR.MATH" / "FLOOR.PRECISE" / "FORMULATEXT" / "GAMMA" / "GAMMA.DIST" / "GAMMA.INV" / "GAMMALN.PRECISE" / "GAUSS" / "HYPGEOM.DIST" / "IFNA" / "IMCOSH" / "IMCOT" / "IMCSC" / "IMCSCH" / "IMSEC" / "IMSECH" / "IMSINH" / "IMTAN" / "ISFORMULA" / "ISOWEEKNUM" / "LOGNORM.DIST" / "LOGNORM.INV" / "MODE.MULT" / "MODE.SNGL" / "MUNIT" / "NEGBINOM.DIST" / "NORM.DIST" / "NORM.INV" / "NORM.S.DIST" / "NORM.S.INV" / "NUMBERVALUE" / "PDURATION" / "PERCENTILE.EXC" / "PERCENTILE.INC" / "PERCENTRANK.EXC" / "PERCENTRANK.INC" / "PERMUTATIONA" / "PHI" / "POISSON.DIST" / "QUARTILE.EXC" / "QUARTILE.INC" / "QUERYSTRING" / "RANK.AVG" / "RANK.EQ" / "RRI" / "SEC" / "SECH" / "SHEET" / "SHEETS" / "SKEW.P" / "STDEV.P" / "STDEV.S" / "T.DIST" / "T.DIST.2T" / "T.DIST.RT" / "T.INV" / "T.INV.2T" / "T.TEST" / "UNICHAR" / "UNICODE" / "VAR.P" / "VAR.S" / "WEBSERVICE" / "WEIBULL.DIST" / "XOR" / "Z.TEST")) / "ECMA.CEILING" / "ISO.CEILING" / "NETWORKDAYS.INTL" / "WORKDAY.INTL" / "FORECAST.ETS" / "FORECAST.ETS.CONFINT" / "FORECAST.ETS.SEASONALITY" / "FORECAST.LINEAR" / "FORECAST.ETS.STAT"
 refFunctionCall = "CHOOSE" chooseParams / "IF" ifParams / "INDEX" indexParams / "INDIRECT" indirectParams / "OFFSET" offsetParams
 futureFunctionCall = ("_xlfn." ( ("ACOT" acotParams) / ("ACOTH" acothParams) / ("AGGREGATE" aggregateParams) / ("ARABIC" arabicParams) / ("BASE" baseParams) / ("BETA.DIST" betaDistParams) / ("BETA.INV" betaInvParams) / ("BINOM.DIST" binomDistParams) / ("BINOM.DIST.RANGE" binomDistRangeParams) / ("BINOM.INV" binomInvParams) / ("BITAND" bitandParams) / ("BITLSHIFT" bitlshiftParams) / ("BITOR" bitorParams) / ("BITRSHIFT" bitrshiftParams) / ("BITXOR" bitxorParams) / ("CEILING.MATH" ceilingMathParams) / ("CEILING.PRECISE" ceilingPreciseParams) / ("CHISQ.DIST" chisqDistParams) / ("CHISQ.DIST.RT" chisqDistRtParams) / ("CHISQ.INV" chisqInvParams) / ("CHISQ.INV.RT" chisqInvRtParams) / ("CHISQ.TEST" chisqTestParams) / ("COMBINA" combinaParams) / ("CONFIDENCE.NORM" confidenceNormParams) / ("CONFIDENCE.T" confidenceTParams) / ("COT" cotParams) / ("COTH" cothParams) / ("COVARIANCE.P" covariancePParams) / ("COVARIANCE.S" covarianceSParams) / ("CSC" cscParams) / ("CSCH" cschParams) / ("DAYS" daysParams) / ("DECIMAL" decimalParams) / ("ERF.PRECISE" erfPreciseParams) / ("ERFC.PRECISE" erfcPreciseParams) / ("EXPON.DIST" exponDistParams) / ("F.DIST" fDistParams) / ("F.DIST.RT" fDistRtParams) / ("F.INV" fInvParams) / ("F.INV.RT" fInvRtParams) / ("F.TEST" fTestParams) / ("FILTERXML" filterxmlParams) / ("FLOOR.MATH" floorMathParams) / ("FLOOR.PRECISE" floorPreciseParams) / ("FORMULATEXT" formulatextParams) / ("GAMMA" gammaParams) / ("GAMMA.DIST" gammaDistParams) / ("GAMMA.INV" gammaInvParams) / ("GAMMALN.PRECISE" gammalnPreciseParams) / ("GAUSS" gaussParams) / ("HYPGEOM.DIST" hypgeomDistParams) / ("IFNA" ifnaParams) / ("IMCOSH" imcoshParams) / ("IMCOT" imcotParams) / ("IMCSC" imcscParams) / ("IMCSCH" imcschParams) / ("IMSEC" imsecParams) / ("IMSECH" imsechParams) / ("IMSINH" imsinhParams) / ("IMTAN" imtanParams) / ("ISFORMULA" isformulaParams) / ("ISOWEEKNUM" isoweeknumParams) / ("LOGNORM.DIST" lognormDistParams) / ("LOGNORM.INV" lognormInvParams) / ("MODE.MULT" modeMultParams) / ("MODE.SNGL" modeSnglParams) / ("MUNIT" munitParams) / ("NEGBINOM.DIST" negbinomDistParams) / ("NORM.DIST" normDistParams) / ("NORM.INV" normInvParams) / ("NORM.S.DIST" normSDistParams) / ("NORM.S.INV" normSInvParams) / ("NUMBERVALUE" numbervalueParams) / ("PDURATION" pdurationParams) / ("PERCENTILE.EXC" percentileExcParams) / ("PERCENTILE.INC" percentileIncParams) / ("PERCENTRANK.EXC" percentrankExcParams) / ("PERCENTRANK.INC" percentrankIncParams) / ("PERMUTATIONA" permutationaParams) / ("PHI" phiParams) / ("POISSON.DIST" poissonDistParams) / ("QUARTILE.EXC" quartileExcParams) / ("QUARTILE.INC" quartileIncParams) / ("QUERYSTRING" querystringParams) / ("RANK.AVG" rankAvgParams) / ("RANK.EQ" rankEqParams) / ("RRI" rriParams) / ("SEC" secParams) / ("SECH" sechParams) / ("SHEET" sheetParams) / ("SHEETS" sheetsParams) / ("SKEW.P" skewPParams) / ("STDEV.P" stdevPParams) / ("STDEV.S" stdevSParams) / ("T.DIST" tDistParams) / ("T.DIST.2T" tdist2tParams) / ("T.DIST.RT" tDistRtParams) / ("T.INV" tInvParams) / ("T.INV.2T" tinv2tParams) / ("T.TEST" tTestParams) / ("UNICHAR" unicharParams) / ("UNICODE" unicodeParams) / ("VAR.P" varPParams) / ("VAR.S" varSParams) / ("WEBSERVICE" webserviceParams) / ("WEIBULL.DIST" weibullDistParams) / ("XOR" xorParams) / ("Z.TEST" zTestParams))) / ("ECMA.CEILING" ecmaCeilingParams) / ("ISO.CEILING" isoCeilingParams) / ("NETWORKDAYS.INTL" networkdaysIntlParams) / ("WORKDAY.INTL" workdayIntlParams) / ("FORECAST.ETS" forecastEtsParams) / ("FORECAST.ETS.CONFINT" forecastetsconfintParams) / ("FORECAST.ETS.SEASONALITY" forecastetsseasonalityParams) / ("FORECAST.LINEAR" forecastLinearParams) / ("FORECAST.ETS.STAT" forecastetsstatParams)
 functionCall = refFunctionCall / futureFunctionCall / cellFunctionCall / userDefinedFunctionCall / "ABS" absParams / "ACCRINT" accrintParams / "ACCRINTM" accrintmParams / "ACOS" acosParams / "ACOSH" acoshParams / "ADDRESS" addressParams / "AMORDEGRC" amordegrcParams / "AMORLINC" amorlincParams / "AND" andParams / "AREAS" areasParams / "ASC" ascParams / "ASIN" asinParams / "ASINH" asinhParams / "ATAN" atanParams / "ATAN2" atan2Params / "ATANH" atanhParams / "AVEDEV" avedevParams / "AVERAGE" averageParams / "AVERAGEA" averageaParams / "AVERAGEIF" averageifParams / "AVERAGEIFS" averageifsParams / "BAHTTEXT" bahttextParams / "BESSELI" besseliParams / "BESSELJ" besseljParams / "BESSELK" besselkParams / "BESSELY" besselyParams / "BETADIST" betadistParams / "BETAINV" betainvParams / "BIN2DEC" bin2decParams / "BIN2HEX" bin2hexParams / "BIN2OCT" bin2octParams / "BINOMDIST" binomdistParams / "CEILING" ceilingParams / "CELL" cellParams / "CHAR" charParams / "CHIDIST" chidistParams / "CHIINV" chiinvParams / "CHITEST" chitestParams / "CLEAN" cleanParams / "CODE" codeParams / "COLUMN" columnParams / "COLUMNS" columnsParams / "COMBIN" combinParams / "COMPLEX" complexParams / "CONCATENATE" concatenateParams / "CONFIDENCE" confidenceParams / "CONVERT" convertParams / "CORREL" correlParams / "COS" cosParams / "COSH" coshParams / "COUNT" countParams / "COUNTA" countaParams / "COUNTBLANK" countblankParams / "COUNTIF" countifParams / "COUNTIFS" countifsParams / "COUPDAYBS" coupdaybsParams / "COUPDAYS" coupdaysParams / "COUPDAYSNC" coupdaysncParams / "COUPNCD" coupncdParams / "COUPNUM" coupnumParams / "COUPPCD" couppcdParams / "COVAR" covarParams / "CRITBINOM" critbinomParams / "CUBEKPIMEMBER" cubekpimemberParams / "CUBEMEMBER" cubememberParams / "CUBEMEMBERPROPERTY" cubememberpropertyParams / "CUBERANKEDMEMBER" cuberankedmemberParams / "CUBESET" cubesetParams / "CUBESETCOUNT" cubesetcountParams / "CUBEVALUE" cubevalueParams / "CUMIPMT" cumipmtParams / "CUMPRINC" cumprincParams / "DATE" dateParams / "DATEDIF" datedifParams / "DATESTRING" datestringParams / "DATEVALUE" datevalueParams / "DAVERAGE" daverageParams / "DAY" dayParams / "DAYS360" days360Params / "DB" dbParams / "DBCS" dbcsParams / "DCOUNT" dcountParams / "DCOUNTA" dcountaParams / "DDB" ddbParams / "DEC2BIN" dec2binParams / "DEC2HEX" dec2hexParams / "DEC2OCT" dec2octParams / "DEGREES" degreesParams / "DELTA" deltaParams / "DEVSQ" devsqParams / "DGET" dgetParams / "DISC" discParams / "DMAX" dmaxParams / "DMIN" dminParams / "DOLLAR" dollarParams / "DOLLARDE" dollardeParams / "DOLLARFR" dollarfrParams / "DPRODUCT" dproductParams / "DSTDEV" dstdevParams / "DSTDEVP" dstdevpParams / "DSUM" dsumParams / "DURATION" durationParams / "DVAR" dvarParams / "DVARP" dvarpParams / "EDATE" edateParams / "EFFECT" effectParams / "EOMONTH" eomonthParams / "ERF" erfParams / "ERFC" erfcParams / "ERROR.TYPE" errorTypeParams / "EVEN" evenParams / "EXACT" exactParams / "EXP" expParams / "EXPONDIST" expondistParams / "FACT" factParams / "FACTDOUBLE" factdoubleParams / "FALSE" falseParams / "FDIST" fdistParams / "FIND" findParams / "FINDB" findbParams / "FINV" finvParams / "FISHER" fisherParams / "FISHERINV" fisherinvParams / "FIXED" fixedParams / "FLOOR" floorParams / "FORECAST" forecastParams / "FREQUENCY" frequencyParams / "FTEST" ftestParams / "FV" fvParams / "FVSCHEDULE" fvscheduleParams / "GAMMADIST" gammadistParams / "GAMMAINV" gammainvParams / "GAMMALN" gammalnParams / "GCD" gcdParams / "GEOMEAN" geomeanParams / "GESTEP" gestepParams / "GETPIVOTDATA" getpivotdataParams / "GROWTH" growthParams / "HARMEAN" harmeanParams / "HEX2BIN" hex2binParams / "HEX2DEC" hex2decParams / "HEX2OCT" hex2octParams / "HLOOKUP" hlookupParams / "HOUR" hourParams / "HYPERLINK" hyperlinkParams / "HYPGEOMDIST" hypgeomdistParams / "IFERROR" iferrorParams / "IMABS" imabsParams / "IMAGINARY" imaginaryParams / "IMARGUMENT" imargumentParams / "IMCONJUGATE" imconjugateParams / "IMCOS" imcosParams / "IMDIV" imdivParams / "IMEXP" imexpParams / "IMLN" imlnParams / "IMLOG10" imlog10Params / "IMLOG2" imlog2Params / "IMPOWER" impowerParams / "IMPRODUCT" improductParams / "IMREAL" imrealParams / "IMSIN" imsinParams / "IMSQRT" imsqrtParams / "IMSUB" imsubParams / "IMSUM" imsumParams / "INFO" infoParams / "INT" intParams / "INTERCEPT" interceptParams / "INTRATE" intrateParams / "IPMT" ipmtParams / "IRR" irrParams / "ISBLANK" isblankParams / "ISERR" iserrParams / "ISERROR" iserrorParams / "ISEVEN" isevenParams / "ISLOGICAL" islogicalParams / "ISNA" isnaParams / "ISNONTEXT" isnontextParams / "ISNUMBER" isnumberParams / "ISODD" isoddParams / "ISPMT" ispmtParams / "ISREF" isrefParams / "ISTEXT" istextParams / "ISTHAIDIGIT" isthaidigitParams / "KURT" kurtParams / "LARGE" largeParams / "LCM" lcmParams / "LEFT" leftParams / "LEFTB" leftbParams / "LEN" lenParams / "LENB" lenbParams / "LINEST" linestParams / "LN" lnParams / "LOG" logParams / "LOG10" log10Params / "LOGEST" logestParams / "LOGINV" loginvParams / "LOGNORMDIST" lognormdistParams / "LOOKUP" lookupParams / "LOWER" lowerParams / "MATCH" matchParams / "MAX" maxParams / "MAXA" maxaParams / "MDETERM" mdetermParams / "MDURATION" mdurationParams / "MEDIAN" medianParams / "MID" midParams / "MIDB" midbParams / "MIN" minParams / "MINA" minaParams / "MINUTE" minuteParams / "MINVERSE" minverseParams / "MIRR" mirrParams / "MMULT" mmultParams / "MOD" modParams / "MODE" modeParams / "MONTH" monthParams / "MROUND" mroundParams / "MULTINOMIAL" multinomialParams / "N" nParams / "NA" naParams / "NEGBINOMDIST" negbinomdistParams / "NETWORKDAYS" networkdaysParams / "NOMINAL" nominalParams / "NORMDIST" normdistParams / "NORMINV" norminvParams / "NORMSDIST" normsdistParams / "NORMSINV" normsinvParams / "NOT" notParams / "NOW" nowParams / "NPER" nperParams / "NPV" npvParams / "NUMBERSTRING" numberstringParams / "OCT2BIN" oct2binParams / "OCT2DEC" oct2decParams / "OCT2HEX" oct2hexParams / "ODD" oddParams / "ODDFPRICE" oddfpriceParams / "ODDFYIELD" oddfyieldParams / "ODDLPRICE" oddlpriceParams / "ODDLYIELD" oddlyieldParams / "OR" orParams / "PEARSON" pearsonParams / "PERCENTILE" percentileParams / "PERCENTRANK" percentrankParams / "PERMUT" permutParams / "PHONETIC" phoneticParams / "PI" piParams / "PMT" pmtParams / "POISSON" poissonParams / "POWER" powerParams / "PPMT" ppmtParams / "PRICE" priceParams / "PRICEDISC" pricediscParams / "PRICEMAT" pricematParams / "PROB" probParams / "PRODUCT" productParams / "PROPER" properParams / "PV" pvParams / "QUARTILE" quartileParams / "QUOTIENT" quotientParams / "RADIANS" radiansParams / "RAND" randParams / "RANDBETWEEN" randbetweenParams / "RANK" rankParams / "RATE" rateParams / "RECEIVED" receivedParams / "REPLACE" replaceParams / "REPLACEB" replacebParams / "REPT" reptParams / "RIGHT" rightParams / "RIGHTB" rightbParams / "ROMAN" romanParams / "ROUND" roundParams / "ROUNDBAHTDOWN" roundbahtdownParams / "ROUNDBAHTUP" roundbahtupParams / "ROUNDDOWN" rounddownParams / "ROUNDUP" roundupParams / "ROW" rowParams / "ROWS" rowsParams / "RSQ" rsqParams / "RTD" rtdParams / "SEARCH" searchParams / "SEARCHB" searchbParams / "SECOND" secondParams / "SERIES" seriesParams / "SERIESSUM" seriessumParams / "SIGN" signParams / "SIN" sinParams / "SINH" sinhParams / "SKEW" skewParams / "SLN" slnParams / "SLOPE" slopeParams / "SMALL" smallParams / "SQRT" sqrtParams / "SQRTPI" sqrtpiParams / "STANDARDIZE" standardizeParams / "STDEV" stdevParams / "STDEVA" stdevaParams / "STDEVP" stdevpParams / "STDEVPA" stdevpaParams / "STEYX" steyxParams / "SUBSTITUTE" substituteParams / "SUBTOTAL" subtotalParams / "SUM" sumParams / "SUMIF" sumifParams / "SUMIFS" sumifsParams / "SUMPRODUCT" sumproductParams / "SUMSQ" sumsqParams / "SUMX2MY2" sumx2my2Params / "SUMX2PY2" sumx2py2Params / "SUMXMY2" sumxmy2Params / "SYD" sydParams / "T" tParams / "TAN" tanParams / "TANH" tanhParams / "TBILLEQ" tbilleqParams / "TBILLPRICE" tbillpriceParams / "TBILLYIELD" tbillyieldParams / "TDIST" tdistParams / "TEXT" textParams / "THAIDAYOFWEEK" thaidayofweekParams / "THAIDIGIT" thaidigitParams / "THAIMONTHOFYEAR" thaimonthofyearParams / "THAINUMSOUND" thainumsoundParams / "THAINUMSTRING" thainumstringParams / "THAISTRINGLENGTH" thaistringlengthParams / "THAIYEAR" thaiyearParams / "TIME" timeParams / "TIMEVALUE" timevalueParams / "TINV" tinvParams / "TODAY" todayParams / "TRANSPOSE" transposeParams / "TREND" trendParams / "TRIM" trimParams / "TRIMMEAN" trimmeanParams / "TRUE" trueParams / "TRUNC" truncParams / "TTEST" ttestParams / "TYPE" typeParams / "UPPER" upperParams / "USDOLLAR" usdollarParams / "VALUE" valueParams / "VAR" varParams / "VARA" varaParams / "VARP" varpParams / "VARPA" varpaParams / "VDB" vdbParams / "VLOOKUP" vlookupParams / "WEEKDAY" weekdayParams / "WEEKNUM" weeknumParams / "WEIBULL" weibullParams / "WORKDAY" workdayParams / "XIRR" xirrParams / "XNPV" xnpvParams / "YEAR" yearParams / "YEARFRAC" yearfracParams / "YIELD" yieldParams / "YIELDDISC" yielddiscParams / "YIELDMAT" yieldmatParams / "ZTEST" ztestParams
 emptyparams = "(" whitespace* ")"
 absParams = "(" argumentExpression ")"
 accrintmParams = "(" argument "," argument "," argument "," argument ("," argument)? ")"
 accrintParams = "(" argument "," argument "," argument "," argument "," argument "," argument ("," argument ("," argument)?)? ")"
 acoshParams = "(" argumentExpression ")"
 acosParams = "(" argumentExpression ")"
 acothParams = "(" argumentExpression ")"
 acotParams = "(" argumentExpression ")"
 addressParams = "(" argument "," argument ["," argument ["," argument ["," argument]]] ")"
 aggregateParams = "(" argument "," argument "," argument ["," argument ["," refArgumentExpression *249("," refArgumentExpression )]] ")"
 amordegrcParams = "(" argument "," argument "," argument "," argument "," argument "," argument ["," argument] ")"
 amorlincParams = "(" argument "," argument "," argument "," argument "," argument "," argument ["," argument] ")"
 andParams = "(" (argumentExpression / (argument 1*254("," argument))) ")"
 arabicParams = "(" argumentExpression ")"
 areasParams = "(" refArgumentExpression ")"
 ascParams = "(" argumentExpression ")"
 asinhParams = "(" argumentExpression ")"
 asinParams = "(" argumentExpression ")"
 atan2Params = "(" argument "," argument ")"
 atanhParams = "(" argumentExpression ")"
 atanParams = "(" argumentExpression ")"
 avedevParams = "(" (argumentExpression / (argument 1*254("," argument))) ")"
 averageaParams = "(" (argumentExpression / (argument 1*254("," argument))) ")"
 averageifParams = "(" refArgumentExpression "," argument ("," refArgumentExpression )? ")"
 averageifsParams = "(" refArgumentExpression "," refArgumentExpression "," argument ("," refArgumentExpression "," argument)* ")"
 averageParams = "(" (argumentExpression / (argument ("," argument)+)) ")"
 bahttextParams = "(" argumentExpression ")"
 baseParams = "(" argument "," argument ["," argument] ")"
 besseliParams = "(" argument "," argument ")"
 besseljParams = "(" argument "," argument ")"
 besselkParams = "(" argument "," argument ")"
 besselyParams = "(" argument "," argument ")"
 betaDistParams = "(" argument "," argument "," argument "," argument ["," argument ["," argument]] ")"
 betadistParams = "(" argument "," argument "," argument ["," argument ["," argument]] ")"
 betainvParams = "(" argument "," argument "," argument ["," argument ["," argument]] ")"
 betaInvParams = "(" argument "," argument "," argument ["," argument ["," argument]] ")"
 bin2decParams = "(" argumentExpression ")"
 bin2hexParams = "(" (argumentExpression / (argument "," argument)) ")"
 bin2octParams = "(" (argumentExpression / (argument "," argument)) ")"
 binomDistRangeParams = "(" argument "," argument "," argument ["," argument] ")"
 binomdistParams = "(" argument "," argument "," argument "," argument ")"
 binomDistParams = "(" argument "," argument "," argument "," argument ")"
 binomInvParams = "(" argument "," argument "," argument ")"
 bitandParams = "(" argument "," argument ")"
 bitlshiftParams = "(" argument "," argument ")"
 bitorParams = "(" argument "," argument ")"
 bitrshiftParams = "(" argument "," argument ")"
 bitxorParams = "(" argument "," argument ")"
 ceilingMathParams = "(" (argumentExpression / (argument "," argument ["," argument])) ")"
 ceilingParams = "(" argument "," argument ")"
 ceilingPreciseParams = "(" argument "," argument ")"
 cellParams = "(" (argumentExpression / (argument "," refArgumentExpression )) ")"
 charParams = "(" argumentExpression ")"
 chidistParams = "(" argument "," argument ")"
 chiinvParams = "(" argument "," argument ")"
 chisqDistParams = "(" argument "," argument "," argument ")"
 chisqDistRtParams = "(" argument "," argument ")"
 chisqInvParams = "(" argument "," argument ")"
 chisqInvRtParams = "(" argument "," argument ")"
 chisqTestParams = "(" argument "," argument ")"
 chitestParams = "(" argument "," argument ")"
 chooseParams = "(" argument "," argument *253("," argument) ")"
 cleanParams = "(" argumentExpression ")"
 codeParams = "(" argumentExpression ")"
 columnParams = "(" [refArgumentExpression ] ")"
 columnsParams = "(" argumentExpression ")"
 combinaParams = "(" argument "," argument ")"
 combinParams = "(" argument "," argument ")"
 complexParams = "(" argument "," argument ["," argument] ")"
 concatenateParams = "(" (argumentExpression / (argument 1*254("," argument))) ")"
 confidenceNormParams = "(" argument "," argument "," argument ")"
 confidenceParams = "(" argument "," argument "," argument ")"
 confidenceTParams = "(" argument "," argument "," argument ")"
 convertParams = "(" argument "," argument "," argument ")"
 correlParams = "(" argument "," argument ")"
 coshParams = "(" argumentExpression ")"
 cosParams = "(" argumentExpression ")"
 cothParams = "(" argumentExpression ")"
 cotParams = "(" argumentExpression ")"
 countaParams = "(" (argumentExpression / (argument 1*254("," argument))) ")"
 countblankParams = "(" refArgumentExpression ")"
 countifParams = "(" refArgumentExpression "," argument ")"
 countifsParams = "(" refArgumentExpression "," argument *126("," refArgumentExpression "," argument) ")"
 countParams = "(" (argumentExpression / (argument 1*254("," argument))) ")"
 coupdaybsParams = "(" argument "," argument "," argument ["," argument] ")"
 coupdaysncParams = "(" argument "," argument "," argument ["," argument] ")"
 coupdaysParams = "(" argument "," argument "," argument ["," argument] ")"
 coupncdParams = "(" argument "," argument "," argument ["," argument] ")"
 coupnumParams = "(" argument "," argument "," argument ["," argument] ")"
 couppcdParams = "(" argument "," argument "," argument ["," argument] ")"
 covariancePParams = "(" argument "," argument ")"
 covarianceSParams = "(" argument "," argument ")"
 covarParams = "(" argument "," argument ")"
 critbinomParams = "(" argument "," argument "," argument ")"
 cschParams = "(" argumentExpression ")"
 cscParams = "(" argumentExpression ")"
 cubekpimemberParams = "(" argument "," argument "," argument ["," argument] ")"
 cubememberParams = "(" argument "," argument ["," argument] ")"
 cubememberpropertyParams = "(" argument "," argument "," argument ")"
 cuberankedmemberParams = "(" argument "," argument "," argument ["," argument] ")"
 cubesetcountParams = "(" argumentExpression ")"
 cubesetParams = "(" argument "," argument ["," argument ["," argument ["," argument]]] ")"
 cubevalueParams = "(" (argumentExpression / (argument "," argument *253("," argument))) ")"
 cumipmtParams = "(" argument "," argument "," argument "," argument "," argument "," argument ")"
 cumprincParams = "(" argument "," argument "," argument "," argument "," argument "," argument ")"
 datedifParams = "(" argument "," argument "," argument ")"
 dateParams = "(" argument "," argument "," argument ")"
 datestringParams = "(" argumentExpression ")"
 datevalueParams = "(" argumentExpression ")"
 daverageParams = "(" refArgumentExpression "," argument "," argument ")"
 dayParams = "(" argumentExpression ")"
 days360Params = "(" argument "," argument ["," argument] ")"
 daysParams = "(" argument "," argument ")"
 dbcsParams = "(" argumentExpression ")"
 dbParams = "(" argument "," argument "," argument "," argument ["," argument] ")"
 dcountaParams = "(" refArgumentExpression "," argument "," argument ")"
 dcountParams = "(" refArgumentExpression "," argument "," argument ")"
 ddbParams = "(" argument "," argument "," argument "," argument ["," argument] ")"
 dec2binParams = "(" (argumentExpression / (argument "," argument)) ")"
 dec2hexParams = "(" (argumentExpression / (argument "," argument)) ")"
 dec2octParams = "(" (argumentExpression / (argument "," argument)) ")"
 decimalParams = "(" argument "," argument ")"
 degreesParams = "(" argumentExpression ")"
 deltaParams = "(" (argumentExpression / (argument "," argument)) ")"
 devsqParams = "(" (argumentExpression / (argument 1*254("," argument))) ")"
 dgetParams = "(" refArgumentExpression "," argument "," argument ")"
 discParams = "(" argument "," argument "," argument "," argument ["," argument] ")"
 dmaxParams = "(" refArgumentExpression "," argument "," argument ")"
 dminParams = "(" refArgumentExpression "," argument "," argument ")"
 dollardeParams = "(" argument "," argument ")"
 dollarfrParams = "(" argument "," argument ")"
 dollarParams = "(" (argumentExpression / (argument "," argument)) ")"
 dproductParams = "(" refArgumentExpression "," argument "," argument ")"
 dstdevParams = "(" refArgumentExpression "," argument "," argument ")"
 dstdevpParams = "(" refArgumentExpression "," argument "," argument ")"
 dsumParams = "(" refArgumentExpression "," argument "," argument ")"
 durationParams = "(" argument "," argument "," argument "," argument "," argument ["," argument] ")"
 dvarParams = "(" refArgumentExpression "," argument "," argument ")"
 dvarpParams = "(" refArgumentExpression "," argument "," argument ")"
 ecmaCeilingParams = "(" argument "," argument ")"
 edateParams = "(" argument "," argument ")"
 effectParams = "(" argument "," argument ")"
 eomonthParams = "(" argument "," argument ")"
 erfcParams = "(" argumentExpression ")"
 erfcPreciseParams = "(" argumentExpression ")"
 erfParams = "(" (argumentExpression / (argument "," argument)) ")"
 erfPreciseParams = "(" argumentExpression ")"
 errorTypeParams = "(" argumentExpression ")"
 evenParams = "(" argumentExpression ")"
 exactParams = "(" argument "," argument ")"
 expondistParams = "(" argument "," argument "," argument ")"
 exponDistParams = "(" argument "," argument "," argument ")"
 expParams = "(" argumentExpression ")"
 factdoubleParams = "(" argumentExpression ")"
 factParams = "(" argumentExpression ")"
 falseParams = emptyparams
 fdistParams = "(" argument "," argument "," argument ")"
 fDistParams = "(" argument "," argument "," argument "," argument ")"
 fDistRtParams = "(" argument "," argument "," argument ")"
 filterxmlParams = "(" argument "," argument ")"
 findbParams = "(" argument "," argument ["," argument] ")"
 findParams = "(" argument "," argument ["," argument] ")"
 finvParams = "(" argument "," argument "," argument ")"
 fInvParams = "(" argument "," argument "," argument ")"
 fInvRtParams = "(" argument "," argument "," argument ")"
 fisherinvParams = "(" argumentExpression ")"
 fisherParams = "(" argumentExpression ")"
 fixedParams = "(" (argumentExpression / (argument "," argument ["," argument])) ")"
 floorMathParams = "(" (argumentExpression / (argument "," argument ["," argument])) ")"
 floorParams = "(" argument "," argument ")"
 floorPreciseParams = "(" argument "," argument ")"
 forecastParams = "(" argument "," argument "," argument ")"
 forecastLinearParams = "(" argument "," argument "," argument ")"
 forecastEtsParams = "(" argument "," argument "," argument ["," argument] ["," argument] ["," argument] ")"
 forecastetsconfintParams = "(" argument "," argument "," argument ["," argument] ["," argument] ["," argument] ["," argument] ")"
 forecastetsseasonalityParams = "(" argument "," argument ["," argument] ["," argument] ")"
 forecastetsstatParams = "(" argument "," argument "," argument ["," argument] ["," argument] ["," argument] ")"
 formulatextParams = "(" refArgumentExpression ")"
 frequencyParams = "(" argument "," argument ")"
 ftestParams = "(" argument "," argument ")"
 fTestParams = "(" argument "," argument ")"
 fvParams = "(" argument "," argument "," argument ["," argument ["," argument]] ")"
 fvscheduleParams = "(" argument "," argument ")"
 gammadistParams = "(" argument "," argument "," argument "," argument ")"
 gammaDistParams = "(" argument "," argument "," argument "," argument ")"
 gammainvParams = "(" argument "," argument "," argument ")"
 gammaInvParams = "(" argument "," argument "," argument ")"
 gammalnParams = "(" argumentExpression ")"
 gammalnPreciseParams = "(" argumentExpression ")"
 gammaParams = "(" argumentExpression ")"
 gaussParams = "(" argumentExpression ")"
 gcdParams = "(" (argumentExpression / (argument 1*254("," argument))) ")"
 geomeanParams = "(" (argumentExpression / (argument 1*254("," argument))) ")"
 gestepParams = "(" (argumentExpression / (argument "," argument)) ")"
 getpivotdataParams = "(" argument "," argument ["," argument ["," argument *125("," argument "," argument)]] ")"
 growthParams = "(" (argumentExpression / (argument "," argument ["," argument ["," argument]])) ")"
 harmeanParams = "(" (argumentExpression / (argument 1*254("," argument))) ")"
 hex2binParams = "(" (argumentExpression / (argument "," argument)) ")"
 hex2decParams = "(" argumentExpression ")"
 hex2octParams = "(" (argumentExpression / (argument "," argument)) ")"
 hlookupParams = "(" argument "," argument "," argument ["," argument] ")"
 hourParams = "(" argumentExpression ")"
 hyperlinkParams = "(" (argumentExpression / (argument "," argument)) ")"
 hypgeomdistParams = "(" argument "," argument "," argument "," argument ")"
 hypgeomDistParams = "(" argument "," argument "," argument "," argument "," argument ")"
 iferrorParams = "(" argument "," argument ")"
 ifnaParams = "(" argument "," argument ")"
 ifParams = "(" (argumentExpression / (argument "," argument ["," argument])) ")"
 imabsParams = "(" argumentExpression ")"
 imaginaryParams = "(" argumentExpression ")"
 imargumentParams = "(" argumentExpression ")"
 imconjugateParams = "(" argumentExpression ")"
 imcoshParams = "(" argumentExpression ")"
 imcosParams = "(" argumentExpression ")"
 imcotParams = "(" argumentExpression ")"
 imcschParams = "(" argumentExpression ")"
 imcscParams = "(" argumentExpression ")"
 imdivParams = "(" argument "," argument ")"
 imexpParams = "(" argumentExpression ")"
 imlnParams = "(" argumentExpression ")"
 imlog10Params = "(" argumentExpression ")"
 imlog2Params = "(" argumentExpression ")"
 impowerParams = "(" argument "," argument ")"
 improductParams = "(" (argumentExpression / (argument 1*254("," argument))) ")"
 imrealParams = "(" argumentExpression ")"
 imsechParams = "(" argumentExpression ")"
 imsecParams = "(" argumentExpression ")"
 imsinhParams = "(" argumentExpression ")"
 imsinParams = "(" argumentExpression ")"
 imsqrtParams = "(" argumentExpression ")"
 imsubParams = "(" argument "," argument ")"
 imsumParams = "(" (argumentExpression / (argument 1*254("," argument))) ")"
 imtanParams = "(" argumentExpression ")"
 indexParams = "(" argument "," argument ["," argument ["," argument]] ")"
 indirectParams = "(" (argumentExpression / (argument "," argument)) ")"
 infoParams = "(" argumentExpression ")"
 interceptParams = "(" argument "," argument ")"
 intParams = "(" argumentExpression ")"
 intrateParams = "(" argument "," argument "," argument "," argument ["," argument] ")"
 ipmtParams = "(" argument "," argument "," argument "," argument ["," argument ["," argument]] ")"
 irrParams = "(" (argumentExpression / (argument "," argument)) ")"
 isblankParams = "(" argumentExpression ")"
 iserrorParams = "(" argumentExpression ")"
 iserrParams = "(" argumentExpression ")"
 isevenParams = "(" argumentExpression ")"
 isformulaParams = "(" refArgumentExpression ")"
 islogicalParams = "(" argumentExpression ")"
 isnaParams = "(" argumentExpression ")"
 isnontextParams = "(" argumentExpression ")"
 isnumberParams = "(" argumentExpression ")"
 isoCeilingParams = "(" (argumentExpression / (argument "," argument)) ")"
 isoddParams = "(" argumentExpression ")"
 isoweeknumParams = "(" argumentExpression ")"
 ispmtParams = "(" argument "," argument "," argument "," argument ")"
 isrefParams = "(" argumentExpression ")"
 istextParams = "(" argumentExpression ")"
 isthaidigitParams = "(" argumentExpression ")"
 kurtParams = "(" (argumentExpression / (argument 1*254("," argument))) ")"
 largeParams = "(" argument "," argument ")"
 lcmParams = "(" (argumentExpression / (argument 1*254("," argument))) ")"
 leftbParams = "(" (argumentExpression / (argument "," argument)) ")"
 leftParams = "(" (argumentExpression / (argument "," argument)) ")"
 lenbParams = "(" argumentExpression ")"
 lenParams = "(" argumentExpression ")"
 linestParams = "(" (argumentExpression / (argument "," argument ["," argument ["," argument]])) ")"
 lnParams = "(" argumentExpression ")"
 log10Params = "(" argumentExpression ")"
 logestParams = "(" (argumentExpression / (argument "," argument ["," argument ["," argument]])) ")"
 loginvParams = "(" argument "," argument "," argument ")"
 lognormdistParams = "(" argument "," argument "," argument ")"
 lognormDistParams = "(" argument "," argument "," argument "," argument ")"
 lognormInvParams = "(" argument "," argument "," argument ")"
 logParams = "(" (argumentExpression / (argument "," argument)) ")"
 lookupParams = "(" argument "," argument ["," argument] ")"
 lowerParams = "(" argumentExpression ")"
 matchParams = "(" argument "," argument ["," argument] ")"
 maxaParams = "(" (argumentExpression / (argument 1*254("," argument))) ")"
 maxParams = "(" (argumentExpression / (argument 1*254("," argument))) ")"
 mdetermParams = "(" argumentExpression ")"
 mdurationParams = "(" argument "," argument "," argument "," argument "," argument ["," argument] ")"
 medianParams = "(" (argumentExpression / (argument 1*254("," argument))) ")"
 midbParams = "(" argument "," argument "," argument ")"
 midParams = "(" argument "," argument "," argument ")"
 minaParams = "(" (argumentExpression / (argument 1*254("," argument))) ")"
 minParams = "(" (argumentExpression / (argument 1*254("," argument))) ")"
 minuteParams = "(" argumentExpression ")"
 minverseParams = "(" argumentExpression ")"
 mirrParams = "(" argument "," argument "," argument ")"
 mmultParams = "(" argument "," argument ")"
 modeMultParams = "(" (argumentExpression / (argument 1*253("," argument))) ")"
 modeParams = "(" (argumentExpression / (argument 1*254("," argument))) ")"
 modeSnglParams = "(" (argumentExpression / (argument 1*253("," argument))) ")"
 modParams = "(" argument "," argument ")"
 monthParams = "(" argumentExpression ")"
 mroundParams = "(" argument "," argument ")"
 multinomialParams = "(" (argumentExpression / (argument 1*254("," argument))) ")"
 munitParams = "(" argumentExpression ")"
 naParams = emptyparams
 negbinomdistParams = "(" argument "," argument "," argument ")"
 negbinomDistParams = "(" argument "," argument "," argument "," argument ")"
 networkdaysIntlParams = "(" argument "," argument ["," argument ["," argument]] ")"
 networkdaysParams = "(" argument "," argument ["," argument] ")"
 nominalParams = "(" argument "," argument ")"
 normdistParams = "(" argument "," argument "," argument "," argument ")"
 normDistParams = "(" argument "," argument "," argument "," argument ")"
 norminvParams = "(" argument "," argument "," argument ")"
 normInvParams = "(" argument "," argument "," argument ")"
 normSDistParams = "(" argument "," argument ")"
 normsdistParams = "(" argumentExpression ")"
 normsinvParams = "(" argumentExpression ")"
 normSInvParams = "(" argumentExpression ")"
 notParams = "(" argumentExpression ")"
 nowParams = emptyparams
 nParams = "(" argumentExpression ")"
 nperParams = "(" argument "," argument "," argument ["," argument ["," argument]] ")"
 npvParams = "(" argument "," argument *253("," argument) ")"
 numberstringParams = "(" argument "," argument ")"
 numbervalueParams = "(" (argumentExpression / (argument "," argument ["," argument])) ")"
 oct2binParams = "(" (argumentExpression / (argument "," argument)) ")"
 oct2decParams = "(" argumentExpression ")"
 oct2hexParams = "(" (argumentExpression / (argument "," argument)) ")"
 oddfpriceParams = "(" argument "," argument "," argument "," argument "," argument "," argument "," argument "," argument ["," argument] ")"
 oddfyieldParams = "(" argument "," argument "," argument "," argument "," argument "," argument "," argument "," argument ["," argument] ")"
 oddlpriceParams = "(" argument "," argument "," argument "," argument "," argument "," argument "," argument ["," argument] ")"
 oddlyieldParams = "(" argument "," argument "," argument "," argument "," argument "," argument "," argument ["," argument] ")"
 oddParams = "(" argumentExpression ")"
 offsetParams = "(" refArgumentExpression "," argument "," argument ["," argument ["," argument]] ")"
 orParams = "(" (argumentExpression / (argument 1*254("," argument))) ")"
 pdurationParams = "(" argument "," argument "," argument ")"
 pearsonParams = "(" argument "," argument ")"
 percentileExcParams = "(" argument "," argument ")"
 percentileIncParams = "(" argument "," argument ")"
 percentileParams = "(" argument "," argument ")"
 percentrankExcParams = "(" argument "," argument ["," argument] ")"
 percentrankIncParams = "(" argument "," argument ["," argument] ")"
 percentrankParams = "(" argument "," argument ["," argument] ")"
 permutationaParams = "(" argument "," argument ")"
 permutParams = "(" argument "," argument ")"
 phiParams = "(" argumentExpression ")"
 phoneticParams = "(" refArgumentExpression ")"
 piParams = emptyparams
 pmtParams = "(" argument "," argument "," argument ["," argument ["," argument]] ")"
 poissonDistParams = "(" argument "," argument "," argument ")"
 poissonParams = "(" argument "," argument "," argument ")"
 powerParams = "(" argument "," argument ")"
 ppmtParams = "(" argument "," argument "," argument "," argument ["," argument ["," argument]] ")"
 pricediscParams = "(" argument "," argument "," argument "," argument ["," argument] ")"
 pricematParams = "(" argument "," argument "," argument "," argument "," argument ["," argument] ")"
 priceParams = "(" argument "," argument "," argument "," argument "," argument "," argument ["," argument] ")"
 probParams = "(" argument "," argument "," argument ["," argument] ")"
 productParams = "(" (argumentExpression / (argument 1*254("," argument))) ")"
 properParams = "(" argumentExpression ")"
 pvParams = "(" argument "," argument "," argument ["," argument ["," argument]] ")"
 quartileExcParams = "(" argument "," argument ")"
 quartileIncParams = "(" argument "," argument ")"
 quartileParams = "(" argument "," argument ")"
 querystringParams = "(" argument "," argument *126( "," argument "," argument) ")"
 quotientParams = "(" argument "," argument ")"
 radiansParams = "(" argumentExpression ")"
 randbetweenParams = "(" argument "," argument ")"
 randParams = emptyparams
 rankAvgParams = "(" argument "," refArgumentExpression ["," argument] ")"
 rankEqParams = "(" argument "," refArgumentExpression ["," argument] ")"
 rankParams = "(" argument "," refArgumentExpression ["," argument] ")"
 rateParams = "(" argument "," argument "," argument ["," argument ["," argument ["," argument]]] ")"
 receivedParams = "(" argument "," argument "," argument "," argument ["," argument] ")"
 replacebParams = "(" argument "," argument "," argument "," argument ")"
 replaceParams = "(" argument "," argument "," argument "," argument ")"
 reptParams = "(" argument "," argument ")"
 rightbParams = "(" (argumentExpression / (argument "," argument)) ")"
 rightParams = "(" (argumentExpression / (argument "," argument)) ")"
 romanParams = "(" (argumentExpression / (argument "," argument)) ")"
 roundbahtdownParams = "(" argumentExpression ")"
 roundbahtupParams = "(" argumentExpression ")"
 rounddownParams = "(" argument "," argument ")"
 roundParams = "(" argument "," argument ")"
 roundupParams = "(" argument "," argument ")"
 rowParams = "(" [refArgumentExpression ] ")"
 rowsParams = "(" argumentExpression ")"
 rriParams = "(" argument "," argument "," argument ")"
 rsqParams = "(" argument "," argument ")"
 rtdParams = "(" argument "," argument "," argument *252("," argument) ")"
 searchbParams = "(" argument "," argument ["," argument] ")"
 searchParams = "(" argument "," argument ["," argument] ")"
 sechParams = "(" argumentExpression ")"
 secondParams = "(" argumentExpression ")"
 secParams = "(" argumentExpression ")"
 seriesParams = "(" argument "," argument "," argument "," argument ["," argument] ")"
 seriessumParams = "(" argument "," argument "," argument "," argument ")"
 sheetParams = "(" argument ")"
 sheetsParams = "(" argument ")"
 signParams = "(" argumentExpression ")"
 sinhParams = "(" argumentExpression ")"
 sinParams = "(" argumentExpression ")"
 skewParams = "(" (argumentExpression / (argument 1*254("," argument))) ")"
 skewPParams = "(" (argumentExpression / (argument 1*253("," argument))) ")"
 slnParams = "(" argument "," argument "," argument ")"
 slopeParams = "(" argument "," argument ")"
 smallParams = "(" argument "," argument ")"
 sqrtParams = "(" argumentExpression ")"
 sqrtpiParams = "(" argumentExpression ")"
 standardizeParams = "(" argument "," argument "," argument ")"
 stdevaParams = "(" (argumentExpression / (argument 1*254("," argument))) ")"
 stdevpaParams = "(" (argumentExpression / (argument 1*254("," argument))) ")"
 stdevParams = "(" (argumentExpression / (argument 1*254("," argument))) ")"
 stdevPParams = "(" (argumentExpression / (argument 1*253("," argument))) ")"
 stdevpParams = "(" (argumentExpression / (argument 1*254("," argument))) ")"
 stdevSParams = "(" (argumentExpression / (argument 1*253("," argument))) ")"
 steyxParams = "(" argument "," argument ")"
 substituteParams = "(" argument "," argument "," argument ["," argument] ")"
 subtotalParams = "(" argument "," refArgumentExpression *253("," refArgumentExpression ) ")"
 sumifParams = "(" refArgumentExpression "," argument ["," refArgumentExpression ] ")"
 sumifsParams = "(" refArgumentExpression "," refArgumentExpression "," argument *126("," refArgumentExpression "," argument) ")"
 sumParams = "(" (argumentExpression / (argument 1*254("," argument))) ")"
 sumproductParams = "(" (argumentExpression / (argument 1*254("," argument))) ")"
 sumsqParams = "(" (argumentExpression / (argument 1*254("," argument))) ")"
 sumx2my2Params = "(" argument "," argument ")"
 sumx2py2Params = "(" argument "," argument ")"
 sumxmy2Params = "(" argument "," argument ")"
 sydParams = "(" argument "," argument "," argument "," argument ")"
 tanhParams = "(" argumentExpression ")"
 tanParams = "(" argumentExpression ")"
 tbilleqParams = "(" argument "," argument "," argument ")"
 tbillpriceParams = "(" argument "," argument "," argument ")"
 tbillyieldParams = "(" argument "," argument "," argument ")"
 tdist2tParams = "(" argument "," argument ")"
 tdistParams = "(" argument "," argument "," argument ")"
 tDistParams = "(" argument "," argument "," argument ")"
 tDistRtParams = "(" argument "," argument ")"
 textParams = "(" argument "," argument ")"
 thaidayofweekParams = "(" argumentExpression ")"
 thaidigitParams = "(" argumentExpression ")"
 thaimonthofyearParams = "(" argumentExpression ")"
 thainumsoundParams = "(" argumentExpression ")"
 thainumstringParams = "(" argumentExpression ")"
 thaistringlengthParams = "(" argumentExpression ")"
 thaiyearParams = "(" argumentExpression ")"
 timeParams = "(" argument "," argument "," argument ")"
 timevalueParams = "(" argumentExpression ")"
 tinv2tParams = "(" argument "," argument ")"
 tinvParams = "(" argument "," argument ")"
 tInvParams = "(" argument "," argument ")"
 todayParams = emptyparams
 tParams = "(" argumentExpression ")"
 transposeParams = "(" argumentExpression ")"
 trendParams = "(" (argumentExpression / (argument "," argument ["," argument ["," argument]])) ")"
 trimmeanParams = "(" argument "," argument ")"
 trimParams = "(" argumentExpression ")"
 trueParams = emptyparams
 truncParams = "(" (argumentExpression / (argument "," argument)) ")"
 ttestParams = "(" argument "," argument "," argument "," argument ")"
 tTestParams = "(" argument "," argument "," argument "," argument ")"
 typeParams = "(" argumentExpression ")"
 unicharParams = "(" argumentExpression ")"
 unicodeParams = "(" argumentExpression ")"
 upperParams = "(" argumentExpression ")"
 usdollarParams = "(" (argumentExpression / (argument "," argument)) ")"
 valueParams = "(" argumentExpression ")"
 varaParams = "(" (argumentExpression / (argument 1*254("," argument))) ")"
 varpaParams = "(" (argumentExpression / (argument 1*254("," argument))) ")"
 varParams = "(" (argumentExpression / (argument 1*254("," argument))) ")"
 varPParams = "(" (argumentExpression / (argument 1*253("," argument))) ")"
 varpParams = "(" (argumentExpression / (argument 1*254("," argument))) ")"
 varSParams = "(" (argumentExpression / (argument 1*253("," argument))) ")"
 vdbParams = "(" argument "," argument "," argument "," argument "," argument ["," argument ["," argument]] ")"
 vlookupParams = "(" argument "," argument "," argument ["," argument] ")"
 webserviceParams = "(" (argumentExpression / (argument "," argument)) ")"
 weekdayParams = "(" (argumentExpression / (argument "," argument)) ")"
 weeknumParams = "(" (argumentExpression / (argument "," argument)) ")"
 weibullDistParams = "(" argument "," argument "," argument "," argument ")"
 weibullParams = "(" argument "," argument "," argument "," argument ")"
 workdayIntlParams = "(" argument "," argument ["," argument ["," argument]] ")"
 workdayParams = "(" argument "," argument ["," argument] ")"
 xirrParams = "(" argument "," argument ["," argument] ")"
 xnpvParams = "(" argument "," argument "," argument ")"
 xorParams = "(" (argumentExpression / (argument 1*253("," argument))) ")"
 yearfracParams = "(" argument "," argument ["," argument] ")"
 yearParams = "(" argumentExpression ")"
 yielddiscParams = "(" argument "," argument "," argument "," argument ["," argument] ")"
 yieldmatParams = "(" argument "," argument "," argument "," argument "," argument ["," argument] ")"
 yieldParams = "(" argument "," argument "," argument "," argument "," argument "," argument ["," argument] ")"
 ztestParams = "(" argument "," argument ["," argument] ")"
 zTestParams = "(" argument "," argument ["," argument] ")"
  
 ref-macro-functionCall = "ABSREF" absrefParams / "ACTIVE.CELL" active-cellParams / "CALL" callParams / "CALLER" callerParams / "EVALUATE" evaluateParams / "GET.DOCUMENT" get-documentParams / "INPUT" inputParams / "LAST.ERROR" last-errorParams / "SCENARIO.GET" scenario-getParams / "SELECTION" selectionParams / "TEXTREF" textrefParams / "VIEW.GET" view-getParams
 macro-functionCall = ref-macro-functionCall / "ADD.BAR" add-barParams / "ADD.COMMAND" add-commandParams / "ADD.MENU" add-menuParams / "ADD.TOOLBAR" add-toolbarParams / "APP.TITLE" app-titleParams / "ARGUMENT" argumentParams / "BREAK" breakParams / "CANCEL.KEY" cancel-keyParams / "CHECK.COMMAND" check-commandParams / "CREATE.OBJECT" create-objectParams / "CUSTOM.REPEAT" custom-repeatParams / "CUSTOM.UNDO" custom-undoParams / "DELETE.BAR" delete-barParams / "DELETE.COMMAND" delete-commandParams / "DELETE.MENU" delete-menuParams / "DELETE.TOOLBAR" delete-toolbarParams / "DEREF" derefParams / "DIALOG.BOX" dialog-boxParams / "DIRECTORY" directoryParams / "DOCUMENTS" documentsParams / "ECHO" echoParams / "ELSE" elseParams / "ELSE.IF" else-ifParams / "ENABLE.COMMAND" enable-commandParams / "ENABLE.TOOL" enable-toolParams / "END.IF" end-ifParams / "ERROR" errorParams / "EXEC" execParams / "EXECUTE" executeParams / "FCLOSE" fcloseParams / "FILES" filesParams / "FOPEN" fopenParams / "FOR" forParams / "FOR.CELL" for-cellParams / "FORMULA.CONVERT" formula-convertParams / "FPOS" fposParams / "FREAD" freadParams / "FREADLN" freadlnParams / "FSIZE" fsizeParams / "FWRITE" fwriteParams / "FWRITELN" fwritelnParams / "GET.BAR" get-barParams / "GET.CELL" get-cellParams / "GET.CHART.ITEM" get-chart-itemParams / "GET.DEF" get-defParams / "GET.FORMULA" get-formulaParams / "GET.LINK.INFO" get-link-infoParams / "GET.MOVIE" get-movieParams / "GET.NAME" get-nameParams / "GET.NOTE" get-noteParams / "GET.OBJECT" get-objectParams / "GET.TOOL" get-toolParams / "GET.TOOLBAR" get-toolbarParams / "GET.WINDOW" get-windowParams / "GET.WORKBOOK" get-workbookParams / "GET.WORKSPACE" get-workspaceParams / "GOTO" gotoParams / "GROUP" groupParams / "HALT" haltParams / "HELP" helpParams / "INITIATE" initiateParams / "LINKS" linksParams / "MOVIE.COMMAND" movie-commandParams / "NAMES" namesParams / "NEXT" nextParams / "NOTE" noteParams / "OPEN.DIALOG" open-dialogParams / "OPTIONS.LISTS.GET" options-lists-getParams / "PAUSE" pauseParams / "POKE" pokeParams / "PRESS.TOOL" press-toolParams / "REFTEXT" reftextParams / "REGISTER" registerParams / "REGISTER.ID" register-idParams / "RELREF" relrefParams / "RENAME.COMMAND" rename-commandParams / "REQUEST" requestParams / "RESET.TOOLBAR" reset-toolbarParams / "RESTART" restartParams / "RESULT" resultParams / "RESUME" resumeParams / "RETURN" returnParams / "SAVE.DIALOG" save-dialogParams / "SAVE.TOOLBAR" save-toolbarParams  / "SET.NAME" set-nameParams / "SET.VALUE" set-valueParams / "SHOW.BAR" show-barParams / "SPELLING.CHECK" spelling-checkParams / "STEP" stepParams / "TERMINATE" terminateParams / "TEXT.BOX" text-boxParams / "UNREGISTER" unregisterParams / "VOLATILE" volatileParams / "WHILE" whileParams / "WINDOW.TITLE" window-titleParams / "WINDOWS" windowsParams
  
 absrefParams = "(" argument "," refArgumentExpression ")"
 active-cellParams = "(" *space ")"
 add-barParams = "(" argument ")"
 add-commandParams = "(" argument "," argument "," argument ["," argument ["," argument]] ")"
 add-menuParams = "(" argument "," argument ["," argument ["," argument]] ")"
 add-toolbarParams = "(" argument ["," argument] ")"
 app-titleParams = "(" argument ")"
 argumentParams = "(" argument ["," argument ["," refArgumentExpression]] ")"
 breakParams = "(" *space ")"
 callParams = "(" (argumentExpression / (argument "," argument *253("," argument))) ")"
 callerParams = "(" *space ")"
 cancel-keyParams = "(" argument ["," refArgumentExpression] ")"
 check-commandParams = "(" argument "," argument "," argument "," argument ["," argument] ")"
 create-objectParams = "(" argument "," argument ["," argument ["," argument ["," argument ["," argument ["," argument ["," argument ["," argument ["," argument ["," argument]]]]]]]]] ")"
 custom-repeatParams = "(" argument ["," argument ["," argument]] ")"
 custom-undoParams = "(" argument ["," argument] ")"
 delete-barParams = "(" argumentExpression ")"
 delete-commandParams = "(" argument "," argument "," argument ["," argument] ")"
 delete-menuParams = "(" argument "," argument ["," argument] ")"
 delete-toolbarParams = "(" argumentExpression ")"
 derefParams = "(" refArgumentExpression ")"
 dialog-boxParams = "(" argumentExpression ")"
 directoryParams = "(" argument ")"
 documentsParams = "(" argument ["," argument] ")"
 echoParams = "(" argument ")"
 elseParams = "(" *space ")"
 else-ifParams = "(" argumentExpression ")"
 enable-commandParams = "(" argument "," argument "," argument "," argument ["," argument] ")"
 enable-toolParams = "(" argument "," argument "," argument ")"
 end-ifParams = "(" *space ")"
 errorParams = "(" argument ["," argument] ")"
 evaluateParams = "(" argumentExpression ")"
 execParams = "(" (argumentExpression / (argument "," argument ["," argument ["," argument]])) ")"
 executeParams = "(" argument "," argument ")"
 fcloseParams = "(" argumentExpression ")"
 filesParams = "(" argument ["," argument] ")"
 fopenParams = "(" (argumentExpression / (argument "," argument)) ")"
 forParams = "(" argument "," argument "," argument ["," argument] ")"
 for-cellParams = "(" (argumentExpression / (argument "," argument ["," argument])) ")"
 formula-convertParams = "(" argument "," argument ["," argument ["," argument ["," argument]]] ")"
 fposParams = "(" (argumentExpression / (argument "," argument)) ")"
 freadParams = "(" argument "," argument ")"
 freadlnParams = "(" argumentExpression ")"
 fsizeParams = "(" argumentExpression ")"
 fwriteParams = "(" argument "," argument ")"
 fwritelnParams = "(" argument "," argument ")"
 get-barParams = "(" argument ["," argument ["," argument ["," argument]]] ")"
 get-cellParams = "(" (argumentExpression / (argument "," refArgumentExpression)) ")"
 get-chart-itemParams = "(" (argumentExpression / (argument "," argument ["," argument])) ")"
 get-defParams = "(" (argumentExpression / (argument "," argument ["," argument])) ")"
 get-documentParams = "(" (argumentExpression / (argument "," argument)) ")"
 get-formulaParams = "(" argumentExpression ")"
 get-link-infoParams = "(" argument "," argument ["," argument ["," argument]] ")"
 get-movieParams = "(" argument "," argument ["," argument] ")"
 get-nameParams = "(" (argumentExpression / (argument "," argument)) ")"
 get-noteParams = "(" argument ["," argument ["," argument]] ")"
 get-objectParams = "(" (argumentExpression / (argument "," argument ["," argument ["," argument ["," argument]]])) ")"
 get-toolParams = "(" (argumentExpression / (argument "," argument ["," argument])) ")"
 get-toolbarParams = "(" (argumentExpression / (argument "," argument)) ")"
 get-windowParams = "(" (argumentExpression / (argument "," argument)) ")"
 get-workbookParams = "(" (argumentExpression / (argument "," argument)) ")"
 get-workspaceParams = "(" argumentExpression ")"
 gotoParams = "(" refArgumentExpression ")"
 groupParams = "(" *space ")"
 haltParams = "(" argument ")"
 helpParams = "(" argument ")"
 initiateParams = "(" argument "," argument ")"
 inputParams = "(" (argumentExpression / (argument "," argument ["," argument ["," argument ["," argument ["," argument ["," argument]]]]])) ")"
 last-errorParams = "(" *space ")"
 linksParams = "(" argument ["," argument] ")"
 movie-commandParams = "(" argument "," argument "," argument ["," argument] ")"
 namesParams = "(" argument ["," argument ["," argument]] ")"
 nextParams = "(" *space ")"
 noteParams = "(" argument ["," argument ["," argument ["," argument]]] ")"
 open-dialogParams = "(" argument ["," argument ["," argument ["," argument]]] ")"
 options-lists-getParams = "(" argumentExpression ")"
 pauseParams = "(" argument ")"
 pokeParams = "(" argument "," argument "," argument ")"
 press-toolParams = "(" argument "," argument "," argument ")"
 reftextParams = "(" refArgumentExpression "," argument ")"
 registerParams = "(" (argumentExpression / (argument "," argument ["," argument ["," argument ["," argument ["," argument ["," argument ["," argument ["," argument ["," argument *245("," argument)]]]]]]]])) ")"
 register-idParams = "(" argument "," argument ["," argument] ")"
 relrefParams = "(" refArgumentExpression "," refArgumentExpression ")"
 rename-commandParams = "(" argument "," argument "," argument "," argument ["," argument] ")"
 requestParams = "(" argument "," argument ")"
 reset-toolbarParams = "(" argumentExpression ")"
 restartParams = "(" argument ")"
 resultParams = "(" argument ")"
 resumeParams = "(" argument ")"
 returnParams = "(" argument ")"
 save-dialogParams = "(" argument ["," argument ["," argument ["," argument ["," argument]]]] ")"
 save-toolbarParams = "(" argument ["," argument] ")"
 scenario-getParams = "(" (argumentExpression / (argument "," argument)) ")"
 selectionParams = "(" *space ")"
 set-nameParams = "(" (argumentExpression / (argument "," argument)) ")"
 set-valueParams = "(" refArgumentExpression "," argument ")"
 show-barParams = "(" argument ")"
 spelling-checkParams = "(" (argumentExpression / (argument "," argument ["," argument])) ")"
 stepParams = "(" *space ")"
 terminateParams = "(" argumentExpression ")"
 text-boxParams = "(" (argumentExpression / (argument "," argument ["," argument ["," argument]])) ")"
 textrefParams = "(" (argumentExpression / (argument "," argument)) ")"
 unregisterParams = "(" argumentExpression ")"
 view-getParams = "(" (argumentExpression / (argument "," argument)) ")"
 volatileParams = "(" argument ")"
 whileParams = "(" argumentExpression ")"
 window-titleParams = "(" argument ")"
 windowsParams = "(" argument ["," argument] ")"
 command-functionCall = "A1.R1C1" a1-r1c1Params / "ACTIVATE" ["?"] activateParams / "ACTIVATE.NEXT" activate-nextParams / "ACTIVATE.NOTES" activate-notesParams / "ACTIVATE.PREV" activate-prevParams / "ACTIVE.CELL.FONT" ["?"] active-cell-fontParams / "ADD.ARROW" add-arrowParams / "ADD.CHART.AUTOFORMAT" ["?"] add-chart-autoformatParams / "ADD.LIST.ITEM" add-list-itemParams / "ADD.OVERLAY" add-overlayParams / "ADD.PRINT.AREA" add-print-areaParams / "ADD.TOOL" add-toolParams / "ADDIN.MANAGER" ["?"] addin-managerParams / "ALERT" alertParams / "ALIGNMENT" ["?"] alignmentParams / "APP.ACTIVATE" app-activateParams / "APP.ACTIVATE.MICROSOFT" app-activate-microsoftParams / "APP.MAXIMIZE" app-maximizeParams / "APP.MINIMIZE" app-minimizeParams / "APP.MOVE" ["?"] app-moveParams / "APP.RESTORE" app-restoreParams / "APP.SIZE" ["?"] app-sizeParams / "APPLY.NAMES" ["?"] apply-namesParams / "APPLY.STYLE" ["?"] apply-styleParams / "ARRANGE.ALL" ["?"] arrange-allParams / "ASSIGN.TO.OBJECT" ["?"] assign-to-objectParams / "ASSIGN.TO.TOOL" ["?"] assign-to-toolParams / "ATTACH.TEXT" ["?"] attach-textParams / "ATTACH.TOOLBARS" ["?"] attach-toolbarsParams / "ATTRIBUTES" ["?"] attributesParams / "AUTO.OUTLINE" auto-outlineParams / "AUTOCORRECT" ["?"] autocorrectParams / "AXES" ["?"] axesParams / "BEEP" beepParams / "BORDER" ["?"] borderParams / "BRING.TO.FRONT" bring-to-frontParams / "CALCULATE.DOCUMENT" calculate-documentParams / "CALCULATE.NOW" calculate-nowParams / "CALCULATION" ["?"] calculationParams / "CANCEL.COPY" cancel-copyParams / "CELL.PROTECTION" ["?"] cell-protectionParams / "CHANGE.LINK" ["?"] change-linkParams / "CHART.ADD.DATA" ["?"] chart-add-dataParams / "CHART.TREND" ["?"] chart-trendParams / "CHART.WIZARD" ["?"] chart-wizardParams / "CHECKBOX.PROPERTIES" ["?"] checkbox-propertiesParams / "CLEAR" ["?"] clearParams / "CLEAR.OUTLINE" clear-outlineParams / "CLEAR.PRINT.AREA" clear-print-areaParams / "CLEAR.ROUTING.SLIP" clear-routing-slipParams / "CLOSE" closeParams / "CLOSE.ALL" close-allParams / "COLOR.PALETTE" ["?"] color-paletteParams / "COLUMN.WIDTH" ["?"] column-widthParams / "COMBINATION" ["?"] combinationParams / "CONSOLIDATE" ["?"] consolidateParams / "CONSTRAIN.NUMERIC" constrain-numericParams / "COPY" copyParams / "COPY.CHART" ["?"] copy-chartParams / "COPY.PICTURE" ["?"] copy-pictureParams / "COPY.TOOL" copy-toolParams / "CREATE.NAMES" ["?"] create-namesParams / "CREATE.PUBLISHER" ["?"] create-publisherParams / "CUSTOMIZE.TOOLBAR" ["?"] customize-toolbarParams / "CUT" cutParams / "DATA.DELETE" ["?"] data-deleteParams / "DATA.FIND" data-findParams / "DATA.FIND.NEXT" data-find-nextParams / "DATA.FIND.PREV" data-find-prevParams / "DATA.FORM" data-formParams / "DATA.LABEL" ["?"] data-labelParams / "DATA.SERIES" ["?"] data-seriesParams / "DEFINE.NAME" ["?"] define-nameParams / "DEFINE.STYLE" ["?"] define-styleParams / "DELETE.ARROW" delete-arrowParams / "DELETE.CHART.AUTOFORMAT" delete-chart-autoformatParams / "DELETE.FORMAT" ["?"] delete-formatParams / "DELETE.NAME" ["?"] delete-nameParams / "DELETE.NOTE" delete-noteParams / "DELETE.OVERLAY" delete-overlayParams / "DELETE.STYLE" delete-styleParams / "DELETE.TOOL" delete-toolParams / "DEMOTE" ["?"] demoteParams / "DISABLE.INPUT" disable-inputParams / "DISPLAY" ["?"] displayParams / "DUPLICATE" duplicateParams / "EDIT.COLOR" ["?"] edit-colorParams / "EDIT.DELETE" ["?"] edit-deleteParams / "EDIT.OBJECT" edit-objectParams / "EDIT.REPEAT" edit-repeatParams / "EDIT.SERIES" ["?"] edit-seriesParams / "EDIT.TOOL" edit-toolParams / "EDITBOX.PROPERTIES" ["?"] editbox-propertiesParams / "EDITION.OPTIONS" ["?"] edition-optionsParams / "ENABLE.OBJECT" enable-objectParams / "ENABLE.TIPWIZARD" enable-tipwizardParams / "ENTER.DATA" enter-dataParams / "ERRORBAR.X" ["?"] errorbar-xParams / "ERRORBAR.Y" ["?"] errorbar-yParams / "EXTEND.POLYGON" extend-polygonParams / "EXTRACT" ["?"] extractParams / "FILE.CLOSE" file-closeParams / "FILE.DELETE" ["?"] file-deleteParams / "FILL.AUTO" fill-autoParams /  "FILL.DOWN" fill-downParams / "FILL.GROUP" ["?"] fill-groupParams / "FILL.LEFT" fill-leftParams / "FILL.RIGHT" fill-rightParams / "FILL.UP" fill-upParams / "FILTER" ["?"] filterParams / "FILTER.ADVANCED" ["?"] filter-advancedParams / "FILTER.SHOW.ALL" filter-show-allParams / "FIND.FILE" ["?"] find-fileParams / "FONT" ["?"] fontParams / "FONT.PROPERTIES" ["?"] font-propertiesParams / "FORMAT.AUTO" ["?"] format-autoParams / "FORMAT.CHART" ["?"] format-chartParams / "FORMAT.CHARTTYPE" ["?"] format-charttypeParams / "FORMAT.FONT" ["?"] format-fontParams / "FORMAT.LEGEND" ["?"] format-legendParams / "FORMAT.MAIN" ["?"] format-mainParams / "FORMAT.MOVE" format-moveParams / "FORMAT.NUMBER" ["?"] format-numberParams / "FORMAT.OVERLAY" ["?"] format-overlayParams / "FORMAT.SHAPE" format-shapeParams / "FORMAT.SIZE" format-sizeParams / "FORMAT.TEXT" ["?"] format-textParams / "FORMULA" formulaParams / "FORMULA.ARRAY" formula-arrayParams / "FORMULA.FILL" formula-fillParams / "FORMULA.FIND" ["?"] formula-findParams / "FORMULA.FIND.NEXT" formula-find-nextParams / "FORMULA.FIND.PREV" formula-find-prevParams / "FORMULA.GOTO" ["?"] formula-gotoParams / "FORMULA.REPLACE" ["?"] formula-replaceParams / "FREEZE.PANES" freeze-panesParams / "FULL" fullParams / "FULL.SCREEN" full-screenParams / "FUNCTION.WIZARD" ["?"] function-wizardParams / "GALLERY.3D.AREA" ["?"] gallery-3d-areaParams / "GALLERY.3D.BAR" ["?"] gallery-3d-barParams / "GALLERY.3D.COLUMN" ["?"] gallery-3d-columnParams / "GALLERY.3D.LINE" ["?"] gallery-3d-lineParams / "GALLERY.3D.PIE" ["?"] gallery-3d-pieParams / "GALLERY.3D.SURFACE" ["?"] gallery-3d-surfaceParams / "GALLERY.AREA" ["?"] gallery-areaParams / "GALLERY.BAR" ["?"] gallery-barParams / "GALLERY.COLUMN" ["?"] gallery-columnParams / "GALLERY.CUSTOM" ["?"] gallery-customParams / "GALLERY.DOUGHNUT" ["?"] gallery-doughnutParams / "GALLERY.LINE" ["?"] gallery-lineParams / "GALLERY.PIE" ["?"] gallery-pieParams / "GALLERY.RADAR" ["?"] gallery-radarParams / "GALLERY.SCATTER" ["?"] gallery-scatterParams / "GOAL.SEEK" ["?"] goal-seekParams / "GRIDLINES" ["?"] gridlinesParams / "HIDE" hideParams / "HIDE.DIALOG" hide-dialogParams / "HIDE.OBJECT" hide-objectParams / "HIDEALL.INKANNOTS" hideall-inkannotsParams / "HIDEALL.NOTES" hideall-notesParams / "HIDECURR.NOTE" hidecurr-noteParams / "HLINE" hlineParams / "HPAGE" hpageParams / "HSCROLL" hscrollParams / "INSERT" ["?"] insertParams / "INSERT.MAP.OBJECT" ["?"] insert-map-objectParams / "INSERT.OBJECT" ["?"] insert-objectParams / "INSERT.PICTURE" ["?"] insert-pictureParams / "INSERT.TITLE" ["?"] insert-titleParams / "INSERTDATATABLE" ["?"] insertdatatableParams / "JUSTIFY" justifyParams / "LABEL.PROPERTIES" ["?"] label-propertiesParams / "LAYOUT" layoutParams / "LEGEND" legendParams / "LINE.PRINT" line-printParams / "LINK.COMBO" link-comboParams / "LINK.FORMAT" link-formatParams / "LIST.NAMES" list-namesParams / "LISTBOX.PROPERTIES" ["?"] listbox-propertiesParams / "MACRO.OPTIONS" ["?"] macro-optionsParams / "MAIL.ADD.MAILER" mail-add-mailerParams / "MAIL.DELETE.MAILER" mail-delete-mailerParams / "MAIL.EDIT.MAILER" ["?"] mail-edit-mailerParams / "MAIL.FORWARD" mail-forwardParams / "MAIL.LOGOFF" mail-logoffParams / "MAIL.LOGON" ["?"] mail-logonParams / "MAIL.NEXT.LETTER" mail-next-letterParams / "MAIL.REPLY" mail-replyParams / "MAIL.REPLY.ALL" mail-reply-allParams / "MAIL.SEND.MAILER" ["?"] mail-send-mailerParams / "MAIN.CHART" ["?"] main-chartParams / "MAIN.CHART.TYPE" ["?"] main-chartTypeParams / "MENU.EDITOR" ["?"] menu-editorParams / "MERGE.STYLES" merge-stylesParams / "MESSAGE" messageParams / "MOVE.BRK" move-brkParams / "MOVE.TOOL" move-toolParams / "NEW" ["?"] newParams / "NEW.WINDOW" new-windowParams / "NEWWEBQUERY" newwebqueryParams / "NORMAL" normalParams / "OBJECT.PROPERTIES" ["?"] object-propertiesParams/ "OBJECT.PROTECTION" ["?"] object-protectionParams / "ON.DATA" on-dataParams/ "ON.DOUBLECLICK" on-doubleclickParams / "ON.ENTRY" on-entryParams / "ON.KEY" on-keyParams / "ON.RECALC" on-recalcParams / "ON.SHEET" on-sheetParams / "ON.TIME" on-timeParams / "ON.WINDOW" on-windowParams / "OPEN" ["?"] openParams/ "OPEN.LINKS" ["?"] open-linksParams / "OPEN.MAIL" ["?"] open-mailParams / "OPEN.TEXT" open-textParams / "OPTIONS.CALCULATION" ["?"] options-calculationParams / "OPTIONS.CHART" ["?"] options-chartParams / "OPTIONS.EDIT" ["?"] options-editParams / "OPTIONS.GENERAL" ["?"] options-generalParams / "OPTIONS.LISTS.ADD" ["?"] options-lists-addParams / "OPTIONS.LISTS.DELETE" options-lists-deleteParams / "OPTIONS.ME" ["?"] options-meParams / "OPTIONS.MENONO" ["?"] options-menonoParams / "OPTIONS.SAVE" ["?"] options-saveParams / "OPTIONS.SPELL" ["?"] options-spellParams / "OPTIONS.TRANSITION" ["?"] options-transitionParams / "OPTIONS.VIEW" ["?"] options-viewParams / "OUTLINE" ["?"] outlineParams / "OVERLAY" ["?"] overlayParams / "OVERLAY.CHART.TYPE" ["?"] overlay-chartTypeParams / "PAGE.SETUP" ["?"] page-setupParams / "PARSE" ["?"] parseParams / "PASTE" pasteParams / "PASTE.LINK" paste-linkParams / "PASTE.PICTURE" paste-pictureParams / "PASTE.PICTURE.LINK" paste-picture-linkParams / "PASTE.SPECIAL" ["?"] paste-specialParams / "PASTE.TOOL" paste-toolParams / "PATTERNS" ["?"] patternsParams / "PICKLIST" ["?"] picklistParams / "PIVOT.ADD.FIELDS" pivot-add-fieldsParams / "PIVOT.FIELD" pivot-fieldParams / "PIVOT.FIELD.GROUP" ["?"] pivot-field-groupParams / "PIVOT.FIELD.PROPERTIES" ["?"] pivot-field-propertiesParams / "PIVOT.FIELD.UNGROUP" ["?"] pivot-field-ungroupParams / "PIVOT.ITEM" pivot-itemParams / "PIVOT.ITEM.PROPERTIES" pivot-item-propertiesParams / "PIVOT.REFRESH" pivot-refreshParams / "PIVOT.SHOW.PAGES" ["?"] pivot-show-pagesParams / "PIVOT.TABLE.CHART" ["?"] pivot-table-chartParams / "PIVOT.TABLE.WIZARD" ["?"] pivot-table-wizardParams / "POST.DOCUMENT" ["?"] post-documentParams / "PRECISION" precisionParams / "PREFERRED" preferredParams / "PRINT" ["?"] printParams / "PRINT.PREVIEW" ["?"] print-previewParams / "PRINTER.SETUP" ["?"] printer-setupParams / "PROMOTE" ["?"] promoteParams / "PROTECT.DOCUMENT" ["?"] protect-documentParams / "PROTECT.REVISIONS" ["?"] protect-revisionsParams / "PUSHBUTTON.PROPERTIES" ["?"] pushbutton-propertiesParams / "QUIT" quitParams / "REMOVE.LIST.ITEM" remove-list-itemParams / "REMOVE.PAGE.BREAK" remove-page-breakParams / "RENAME.OBJECT" rename-objectParams / "REPLACE.FONT" ["?"] replace-fontParams /"RESET.TOOL" reset-toolParams / "RM.PRINT.AREA" rm-print-areaParams / "ROUTE.DOCUMENT" route-documentParams / "ROUTING.SLIP" ["?"] routing-slipParams / "ROW.HEIGHT" ["?"] row-heightParams / "RUN" ["?"] runParams / "SAVE" saveParams / "SAVE.AS" ["?"] save-asParams / "SAVE.COPY.AS" save-copy-asParams / "SAVE.NEW.OBJECT" ["?"] save-new-objectParams / "SAVE.WORKBOOK" ["?"] save-workbookParams / "SAVE.WORKSPACE" ["?"] save-workspaceParams / "SCALE" ["?"] scaleParams / "SCENARIO.ADD" ["?"] scenario-addParams / "SCENARIO.CELLS" ["?"] scenario-cellsParams / "SCENARIO.DELETE" scenario-deleteParams / "SCENARIO.EDIT" ["?"] scenario-editParams / "SCENARIO.MERGE" ["?"] scenario-mergeParams / "SCENARIO.SHOW" scenario-showParams / "SCENARIO.SHOW.NEXT" scenario-show-nextParams / "SCENARIO.SUMMARY" ["?"] scenario-summaryParams / "SCROLLBAR.PROPERTIES" ["?"] scrollbar-propertiesParams / "SELECT" selectParams / "SELECT.ALL" select-allParams / "SELECT.CHART" select-chartParams / "SELECT.END" select-endParams / "SELECT.LAST.CELL" select-last-cellParams / "SELECT.LIST.ITEM" select-list-itemParams / "SELECT.PLOT.AREA" select-plot-areaParams / "SELECT.SPECIAL" ["?"] select-specialParams / "SEND.KEYS" send-keysParams / "SEND.MAIL" ["?"] send-mailParams / "SEND.TO.BACK" send-to-backParams / "SERIES.AXES" ["?"] series-axesParams / "SERIES.ORDER" ["?"] series-orderParams / "SERIES.X" ["?"] series-xParams / "SERIES.Y" ["?"] series-yParams / "SET.CONTROL.VALUE" set-control-valueParams / "SET.CRITERIA" set-criteriaParams / "SET.DATABASE" set-databaseParams / "SET.DIALOG.DEFAULT" set-dialog-defaultParams / "SET.DIALOG.FOCUS" set-dialog-focusParams / "SET.EXTRACT" set-extractParams / "SET.LIST.ITEM" set-list-itemParams / "SET.PAGE.BREAK" set-page-breakParams / "SET.PREFERRED" set-preferredParams / "SET.PRINT.AREA" set-print-areaParams / "SET.PRINT.TITLES" ["?"] set-print-titlesParams / "SET.UPDATE.STATUS" ["?"] set-update-statusParams / "SHARE" shareParams / "SHARE.NAME" ["?"] share-nameParams / "SHEET.BACKGROUND" ["?"] sheet-backgroundParams / "SHORT.MENUS" short-menusParams / "SHOW.ACTIVE.CELL" show-active-cellParams / "SHOW.CLIPBOARD" show-clipboardParams / "SHOW.DETAIL" ["?"] show-detailParams / "SHOW.DIALOG" show-dialogParams / "SHOW.INFO" show-infoParams / "SHOW.LEVELS" show-levelsParams / "SHOW.TOOLBAR" ["?"] show-toolbarParams / "SORT" ["?"] sortParams / "SORT.SPECIAL" ["?"] sort-specialParams / "SOUND.NOTE" sound-noteParams / "SOUND.PLAY" sound-playParams / "SPELLING" spellingParams / "SPLIT" ["?"] splitParams / "STANDARD.FONT" ["?"] standard-fontParams / "STANDARD.WIDTH" ["?"] standard-widthParams / "STYLE" ["?"] styleParams / "SUBSCRIBE.TO" ["?"] subscribe-toParams / "SUBTOTAL.CREATE" ["?"] subtotal-createParams / "SUBTOTAL.REMOVE" subtotal-removeParams / "SUMMARY.INFO" ["?"] summary-infoParams / "TAB.ORDER" ["?"] tab-orderParams / "TABLE" ["?"] tableParams / "TEXT.TO.COLUMNS" ["?"] text-to-columnsParams / "TRACER.CLEAR" tracer-clearParams / "TRACER.DISPLAY" tracer-displayParams / "TRACER.ERROR" tracer-errorParams / "TRACER.NAVIGATE" tracer-navigateParams / "TRAVERSE.NOTES" traverse-notesParams / "UNDO" undoParams / "UNGROUP" ungroupParams / "UNGROUP.SHEETS" ungroup-sheetsParams / "UNHIDE" ["?"] unhideParams / "UNLOCKED.NEXT" unlocked-nextParams / "UNLOCKED.PREV" unlocked-prevParams / "UNPROTECT.REVISIONS" unprotect-revisionsParams / "UPDATE.LINK" ["?"] update-linkParams / "VBA.INSERT.FILE" ["?"] vba-insert-fileParams / "VBA.MAKE.ADDIN" ["?"] vba-make-addinParams / "VBA.PROCEDURE.DEFINITION" ["?"] vba-procedure-definitionParams / "VBAACTIVATE"vbaactivateParams / "VIEW.3D" ["?"] view-3dParams / "VIEW.DEFINE" ["?"] view-defineParams / "VIEW.DELETE" view-deleteParams / "VIEW.SHOW" ["?"] view-showParams / "VLINE" vlineParams / "VPAGE" vpageParams / "VSCROLL" vscrollParams / "WAIT" waitParams / "WEB.PUBLISH" web-publishParams / "WINDOW.MAXIMIZE" window-maximizeParams / "WINDOW.MINIMIZE" window-minimizeParams / "WINDOW.MOVE" ["?"] window-moveParams / "WINDOW.RESTORE" window-restoreParams / "WINDOW.SIZE" ["?"] window-sizeParams / "WORKBOOK.ACTIVATE" workbook-activateParams / "WORKBOOK.ADD" ["?"] workbook-addParams / "WORKBOOK.COPY" ["?"] workbook-copyParams / "WORKBOOK.DELETE" workbook-deleteParams / "WORKBOOK.HIDE" workbook-hideParams / "WORKBOOK.INSERT" ["?"] workbook-insertParams / "WORKBOOK.MOVE" ["?"] workbook-moveParams / "WORKBOOK.NAME" ["?"] workbook-nameParams / "WORKBOOK.NEW" ["?"] workbook-newParams / "WORKBOOK.NEXT" workbook-nextParams / "WORKBOOK.OPTIONS" ["?"] workbook-optionsParams / "WORKBOOK.PREV" workbook-prevParams / "WORKBOOK.PROTECT" ["?"] workbook-protectParams / "WORKBOOK.SCROLL" workbook-scrollParams / "WORKBOOK.SELECT" workbook-selectParams / "WORKBOOK.TAB.SPLIT" ["?"] workbook-tab-splitParams / "WORKBOOK.UNHIDE" ["?"] workbook-unhideParams / "WORKGROUP" ["?"] workgroupParams / "WORKGROUP.OPTIONS" ["?"] workgroup-optionsParams / "WORKSPACE" ["?"] workspaceParams / "ZOOM" ["?"] zoomParams
 a1-r1c1Params = "(" argument ")"
 activateParams = "(" argument ["," argument] ")"
 activate-nextParams = "(" argument ")"
 activate-notesParams = "(" argument ["," argument] ")"
 activate-prevParams = "(" argument ")"
 active-cell-fontParams = "(" argument *13("," argument) ")"
 add-arrowParams = "(" *space ")"
 add-chart-autoformatParams = "(" argument ["," argument] ")"
 add-list-itemParams = "(" argument ["," argument] ")"
 add-overlayParams = "(" *space ")"
 add-print-areaParams = "(" *space ")"
 add-toolParams = "(" argument *2("," argument) ")"
 addin-managerParams = "(" argument *2("," argument) ")"
 alertParams = "(" argument *2("," argument) ")"
 alignmentParams = "(" argument *9("," argument) ")"
 app-activateParams = "(" argument ["," argument] ")"
 app-activate-microsoftParams = "(" argument ")"
 app-maximizeParams = "(" *space ")"
 app-minimizeParams = "(" *space ")"
 app-moveParams = "(" argument ["," argument] ")"
 app-restoreParams = "(" *space ")"
 app-sizeParams = "(" argument ["," argument] ")"
 apply-namesParams = "(" argument *6("," argument) ")"
 apply-styleParams = "(" argument ")"
 arrange-allParams = "(" argument *3("," argument) ")"
 assign-to-objectParams = "(" argument ")"
 assign-to-toolParams = "(" argument *2("," argument) ")"
 attach-textParams = "(" argument *2("," argument) ")"
 attach-toolbarsParams = "(" *space ")"
 attributesParams = "(" argument ["," argument] ")"
 auto-outlineParams = "(" *space ")"
 autocorrectParams = "(" argument ["," argument] ")"
 axesParams = "(" argument *5("," argument) ")"
 beepParams = "(" argument ")"
 borderParams = "(" argument *26("," argument) ")"
 bring-to-frontParams = "(" *space ")"
 calculate-documentParams = "(" *space ")"
 calculate-nowParams = "(" *space ")"
 calculationParams = "(" argument *10("," argument) ")"
 cancel-copyParams = "(" argument ")"
 cell-protectionParams = "(" argument ["," argument] ")"
 change-linkParams = "(" argument *2("," argument) ")"
 chart-add-dataParams = "(" argument *5("," argument) ")"
 chart-trendParams = "(" argument *7("," argument) ")"
 chart-wizardParams = "(" argument *13("," argument) ")"
 checkbox-propertiesParams = "(" argument *4("," argument) ")"
 clearParams = "(" argument ")"
 clear-outlineParams = "(" *space ")"
 clear-print-areaParams = "(" *space ")"
 clear-routing-slipParams = "(" argument ")"
 closeParams = "(" argument ["," argument] ")"
 close-allParams = "(" *space ")"
 color-paletteParams = "(" argument ")"
 column-widthParams = "(" argument *4("," argument) ")"
 combinationParams = "(" argument ")"
 consolidateParams = "(" argument *4("," argument) ")"
 constrain-numericParams = "(" argument ")"
 copyParams = "(" argument ["," argument] ")"
 copy-chartParams = "(" argument ")"
 copy-pictureParams = "(" argument *2("," argument) ")"
 copy-toolParams = "(" argument ["," argument] ")"
 create-namesParams = "(" argument *3("," argument) ")"
 create-publisherParams = "(" argument *3("," argument) ")"
 customize-toolbarParams = "(" argument ")"
 cutParams = "(" argument ["," argument] ")"
 data-deleteParams = "(" *space ")"
 data-findParams = "(" argument ")"
 data-find-nextParams = "(" *space ")"
 data-find-prevParams = "(" *space ")"
 data-formParams = "(" *space ")"
 data-labelParams = "(" argument *9("," argument) ")"
 data-seriesParams = "(" argument *5("," argument) ")"
 define-nameParams = "(" argument *6("," argument) ")"
 define-styleParams = "(" argument *13("," argument) ")"
 delete-arrowParams = "(" *space ")"
 delete-chart-autoformatParams = "(" argument ")"
 delete-formatParams = "(" argument ")"
 delete-nameParams = "(" argument ")"
 delete-noteParams = "(" argument ")"
 delete-overlayParams = "(" *space ")"
 delete-styleParams = "(" argument ")"
 delete-toolParams = "(" argument ["," argument] ")"
 demoteParams = "(" argument ")"
 disable-inputParams = "(" argument ")"
 displayParams = "(" argument *8("," argument) ")"
 duplicateParams = "(" *space ")"
 edit-colorParams = "(" argument *3("," argument) ")"
 edit-deleteParams = "(" argument ")"
 edit-objectParams = "(" argument ")"
 edit-repeatParams = "(" *space ")"
 edit-seriesParams = "(" argument *6("," argument) ")"
 edit-toolParams = "(" argument ["," argument] ")"
 editbox-propertiesParams = "(" argument *3("," argument) ")"
 edition-optionsParams = "(" argument *6("," argument) ")"
 enable-objectParams = "(" argument ["," argument] ")"
 enable-tipwizardParams = "(" argument ")"
 enter-dataParams = "(" argument ")"
 errorbar-xParams = "(" argument *3("," argument) ")"
 errorbar-yParams = "(" argument *3("," argument) ")"
 extend-polygonParams = "(" argument ")"
 extractParams = "(" argument ")"
 file-closeParams = "(" argument ["," argument] ")"
 file-deleteParams = "(" argument ")"
 fill-autoParams = "(" argument ["," argument] ")"
 fill-downParams = "(" *space ")"
 fill-groupParams = "(" argument ")"
 fill-leftParams = "(" *space ")"
 fill-rightParams = "(" *space ")"
 fill-upParams = "(" *space ")"
 filterParams = "(" argument *5("," argument) ")"
 filter-advancedParams = "(" argument *4("," argument) ")"
 filter-show-allParams = "(" *space ")"
 find-fileParams = "(" *space ")"
 fontParams = "(" argument ["," argument] ")"
 font-propertiesParams = "(" argument *13("," argument) ")"
 format-autoParams = "(" argument *6("," argument) ")"
 format-chartParams = "(" argument *17("," argument) ")"
 format-charttypeParams = "(" argument *3("," argument) ")"
 format-fontParams = "(" argument *14("," argument) ")"
 format-legendParams = "(" argument ")"
 format-mainParams = "(" argument *13("," argument) ")"
 format-moveParams = "(" argument *2("," argument) ")"
 format-numberParams = "(" argument ")"
 format-overlayParams = "(" argument *13("," argument) ")"
 format-shapeParams = "(" argument *4("," argument) ")"
 format-sizeParams = "(" argument *2("," argument) ")"
 format-textParams = "(" argument *10("," argument) ")"
 formulaParams = "(" argument ["," argument] ")"
 formula-arrayParams = "(" argument ["," argument] ")"
 formula-fillParams = "(" argument ["," argument] ")"
 formula-findParams = "(" argument *11("," argument) ")"
 formula-find-nextParams = "(" *space ")"
 formula-find-prevParams = "(" *space ")"
 formula-gotoParams = "(" argument ["," argument] ")"
 formula-replaceParams = "(" argument *10("," argument) ")"
 freeze-panesParams = "(" argument *2("," argument) ")"
 fullParams = "(" argument ")"
 full-screenParams = "(" argument ")"
 function-wizardParams = "(" argument ")"
 gallery-3d-areaParams = "(" argument ")"
 gallery-3d-barParams = "(" argument ")"
 gallery-3d-columnParams = "(" argument ")"
 gallery-3d-lineParams = "(" argument ")"
 gallery-3d-pieParams = "(" argument ")"
 gallery-3d-surfaceParams = "(" argument ")"
 gallery-areaParams = "(" argument ["," argument] ")"
 gallery-barParams = "(" argument ["," argument] ")"
 gallery-columnParams = "(" argument ["," argument] ")"
 gallery-customParams = "(" argument ")"
 gallery-doughnutParams = "(" argument ["," argument] ")"
 gallery-lineParams = "(" argument ["," argument] ")"
 gallery-pieParams = "(" argument ["," argument] ")"
 gallery-radarParams = "(" argument ["," argument] ")"
 gallery-scatterParams = "(" argument ["," argument] ")"
 goal-seekParams = "(" argument *2("," argument) ")"
 gridlinesParams = "(" argument *6("," argument) ")"
 hideParams = "(" *space ")"
 hide-dialogParams = "(" argument ")"
 hide-objectParams = "(" argument ["," argument] ")"
 hideall-inkannotsParams = "(" argument ")"
 hideall-notesParams = "(" argument ")"
 hidecurr-noteParams = "(" argument ["," argument] ")"
 hlineParams = "(" argument ")"
 hpageParams = "(" argument ")"
 hscrollParams = "(" argument ["," argument] ")"
 insertParams = "(" argument ["," argument] ")"
 insert-map-objectParams = "(" *space ")"
 insert-objectParams = "(" argument *12("," argument) ")"
 insert-pictureParams = "(" argument ["," argument] ")"
 insert-titleParams = "(" argument *4("," argument) ")"
 insertdatatableParams = "(" argument ")"
 justifyParams = "(" *space ")"
 label-propertiesParams = "(" argument *2("," argument) ")"
 layoutParams = "(" *space ")"
 legendParams = "(" argument ")"
 line-printParams = "(" argument *10("," argument) ")"
 link-comboParams = "(" argument ")"
 link-formatParams = "(" *space ")"
 list-namesParams = "(" *space ")"
 listbox-propertiesParams = "(" argument *4("," argument) ")"
 macro-optionsParams = "(" argument *9("," argument) ")"
 mail-add-mailerParams = "(" *space ")"
 mail-delete-mailerParams = "(" *space ")"
 mail-edit-mailerParams = "(" argument *5("," argument) ")"
 mail-forwardParams = "(" *space ")"
 mail-logoffParams = "(" *space ")"
 mail-logonParams = "(" argument *2("," argument) ")"
 mail-next-letterParams = "(" *space ")"
 mail-replyParams = "(" *space ")"
 mail-reply-allParams = "(" *space ")"
 mail-send-mailerParams = "(" argument ["," argument] ")"
 main-chartParams = "(" argument *9("," argument) ")"
 main-chartTypeParams = "(" argument ")"
 menu-editorParams = "(" *space ")"
 merge-stylesParams = "(" argument ")"
 messageParams = "(" argument ["," argument] ")"
 move-brkParams = "(" argument *3("," argument) ")"
 move-toolParams = "(" argument *5("," argument) ")"
 newParams = "(" argument *2("," argument) ")"
 new-windowParams = "(" *space ")"
 newwebqueryParams = "(" argument ")"
 normalParams = "(" *space ")"
 object-propertiesParams = "(" argument ["," argument] ")"
 object-protectionParams = "(" argument ["," argument] ")"
 on-dataParams = "(" argument ["," argument] ")"
 on-doubleclickParams = "(" argument ["," argument] ")"
 on-entryParams = "(" argument ["," argument] ")"
 on-keyParams = "(" argument ["," argument] ")"
 on-recalcParams = "(" argument ["," argument] ")"
 on-sheetParams = "(" argument *2("," argument) ")"
 on-timeParams = "(" argument *3("," argument) ")"
 on-windowParams = "(" argument ["," argument] ")"
 openParams = "(" argument *16("," argument) ")"
 open-linksParams = "(" argument *14("," argument) ")"
 open-mailParams = "(" argument ["," argument] ")"
 open-textParams = "(" argument *16("," argument) ")"
 options-calculationParams = "(" argument *9("," argument) ")"
 options-chartParams = "(" argument *2("," argument) ")"
 options-editParams = "(" argument *10("," argument) ")"
 options-generalParams = "(" argument *13("," argument) ")"
 options-lists-addParams = "(" argument ["," argument] ")"
 options-lists-deleteParams = "(" argument ")"
 options-meParams = "(" argument *8("," argument) ")"
 options-menonoParams = "(" argument *4("," argument) ")"
 options-saveParams = "(" argument *3("," argument) ")"
 options-spellParams = "(" argument *11("," argument) ")"
 options-transitionParams = "(" argument *4("," argument) ")"
 options-viewParams = "(" argument *17("," argument) ")"
 outlineParams = "(" argument *3("," argument) ")"
 overlayParams = "(" argument *11("," argument) ")"
 overlay-chartTypeParams = "(" argument ")"
 page-setupParams = "(" argument *29("," argument) ")"
 parseParams = "(" argument ["," argument] ")"
 pasteParams = "(" argument ")"
 paste-linkParams = "(" *space ")"
 paste-pictureParams = "(" *space ")"
 paste-picture-linkParams = "(" *space ")"
 paste-specialParams = "(" argument *6("," argument) ")"
 paste-toolParams = "(" argument ["," argument] ")"
 patternsParams = "(" argument *12("," argument) ")"
 picklistParams = "(" *space ")"
 pivot-add-fieldsParams = "(" argument *4("," argument) ")"
 pivot-fieldParams = "(" argument *3("," argument) ")"
 pivot-field-groupParams = "(" argument *3("," argument) ")"
 pivot-field-propertiesParams = "(" argument *6("," argument) ")"
 pivot-field-ungroupParams = "(" *space ")"
 pivot-itemParams = "(" argument *3("," argument) ")"
 pivot-item-propertiesParams = "(" argument *6("," argument) ")"
 pivot-refreshParams = "(" argument ")"
 pivot-show-pagesParams = "(" argument ["," argument] ")"
 pivot-table-chartParams = "(" argument *15("," argument) ")"
 pivot-table-wizardParams = "(" argument *15("," argument) ")"
 post-documentParams = "(" argument ")"
 precisionParams = "(" argument ")"
 preferredParams = "(" *space ")"
 printParams = "(" argument *16("," argument) ")"
 print-previewParams = "(" argument ")"
 printer-setupParams = "(" argument ")"
 promoteParams = "(" argument ")"
 protect-documentParams = "(" argument *6("," argument) ")"
 protect-revisionsParams = "(" *space ")"
 pushbutton-propertiesParams = "(" argument *5("," argument) ")"
 quitParams = "(" *space ")"
 remove-list-itemParams = "(" argument ["," argument] ")"
 remove-page-breakParams = "(" argument ["," argument] ")"
 rename-objectParams = "(" argument ")"
 replace-fontParams = "(" argument *9("," argument) ")"
 reset-toolParams = "(" argument ["," argument] ")"
 rm-print-areaParams = "(" argument ")"
 route-documentParams = "(" *space ")"
 routing-slipParams = "(" argument *5("," argument) ")"
 row-heightParams = "(" argument *3("," argument) ")"
 runParams = "(" argument ["," argument] ")"
 saveParams = "(" *space ")"
 save-asParams = "(" argument *6("," argument) ")"
 save-copy-asParams = "(" argument ")"
 save-new-objectParams = "(" argument ")"
 save-workbookParams = "(" argument *5("," argument) ")"
 save-workspaceParams = "(" argument ")"
 scaleParams = "(" argument *9("," argument) ")"
 scenario-addParams = "(" argument *5("," argument) ")"
 scenario-cellsParams = "(" argument ")"
 scenario-deleteParams = "(" argument ")"
 scenario-editParams = "(" argument *6("," argument) ")"
 scenario-mergeParams = "(" argument ")"
 scenario-showParams = "(" argument ")"
 scenario-show-nextParams = "(" *space ")"
 scenario-summaryParams = "(" argument ["," argument] ")"
 scrollbar-propertiesParams = "(" argument *6("," argument) ")"
 selectParams = "(" argument ["," argument] ")"
 select-allParams = "(" *space ")"
 select-chartParams = "(" *space ")"
 select-endParams = "(" argument ")"
 select-last-cellParams = "(" *space ")"
 select-list-itemParams = "(" argument ["," argument] ")"
 select-plot-areaParams = "(" *space ")"
 select-specialParams = "(" argument *2("," argument) ")"
 send-keysParams = "(" argument ["," argument] ")"
 send-mailParams = "(" argument *2("," argument) ")"
 send-to-backParams = "(" *space ")"
 series-axesParams = "(" argument ")"
 series-orderParams = "(" argument *2("," argument) ")"
 series-xParams = "(" argument ")"
 series-yParams = "(" argument ["," argument] ")"
 set-control-valueParams = "(" argument ")"
 set-criteriaParams = "(" *space ")"
 set-databaseParams = "(" *space ")"
 set-dialog-defaultParams = "(" argument ")"
 set-dialog-focusParams = "(" argument ")"
 set-extractParams = "(" *space ")"
 set-list-itemParams = "(" argument ["," argument] ")"
 set-page-breakParams = "(" *space ")"
 set-preferredParams = "(" argument ")"
 set-print-areaParams = "(" argument ")"
 set-print-titlesParams = "(" argument ["," argument] ")"
 set-update-statusParams = "(" argument *2("," argument) ")"
 shareParams = "(" *space ")"
 share-nameParams = "(" argument ")"
 sheet-backgroundParams = "(" argument ["," argument] ")"
 short-menusParams = "(" argument ")"
 show-active-cellParams = "(" *space ")"
 show-clipboardParams = "(" *space ")"
 show-detailParams = "(" argument *3("," argument) ")"
 show-dialogParams = "(" argument ")"
 show-infoParams = "(" argument ")"
 show-levelsParams = "(" argument ["," argument] ")"
 show-toolbarParams = "(" argument *9("," argument) ")"
 sortParams = "(" argument *16("," argument) ")"
 sort-specialParams = "(" argument *13("," argument) ")"
 sound-noteParams = "(" argument *2("," argument) ")"
 sound-playParams = "(" argument *2("," argument) ")"
 spellingParams = "(" argument *5("," argument) ")"
 splitParams = "(" argument ["," argument] ")"
 standard-fontParams = "(" argument *8("," argument) ")"
 standard-widthParams = "(" argument ")"
 styleParams = "(" argument ["," argument] ")"
 subscribe-toParams = "(" argument ["," argument] ")"
 subtotal-createParams = "(" argument *5("," argument) ")"
 subtotal-removeParams = "(" *space ")"
 summary-infoParams = "(" argument *4("," argument) ")"
 tab-orderParams = "(" *space ")"
 tableParams = "(" argument ["," argument] ")"
 text-to-columnsParams = "(" argument *13("," argument) ")"
 tracer-clearParams = "(" *space ")"
 tracer-displayParams = "(" argument ["," argument] ")"
 tracer-errorParams = "(" *space ")"
 tracer-navigateParams = "(" argument *2("," argument) ")"
 traverse-notesParams = "(" argument ["," argument] ")"
 undoParams = "(" *space ")"
 ungroupParams = "(" *space ")"
 ungroup-sheetsParams = "(" *space ")"
 unhideParams = "(" argument ")"
 unlocked-nextParams = "(" *space ")"
 unlocked-prevParams = "(" *space ")"
 unprotect-revisionsParams = "(" *space ")"
 update-linkParams = "(" argument ["," argument] ")"
 vba-insert-fileParams = "(" argument ")"
 vba-make-addinParams = "(" argument ")"
 vba-procedure-definitionParams = "(" *space ")"
 vbaactivateParams = "(" argument ["," argument] ")"
 view-3dParams = "(" argument *5("," argument) ")"
 view-defineParams = "(" argument *2("," argument) ")"
 view-deleteParams = "(" argument ")"
 view-showParams = "(" argument ")"
 vlineParams = "(" argument ")"
 vpageParams = "(" argument ")"
 vscrollParams = "(" argument ["," argument] ")"
 waitParams = "(" argument ")"
 web-publishParams = "(" argument *8("," argument) ")"
 window-maximizeParams = "(" argument ")"
 window-minimizeParams = "(" argument ")"
 window-moveParams = "(" argument *2("," argument) ")"
 window-restoreParams = "(" argument ")"
 window-sizeParams = "(" argument *2("," argument) ")"
 workbook-activateParams = "(" argument ["," argument] ")"
 workbook-addParams = "(" argument *2("," argument) ")"
 workbook-copyParams = "(" argument *2("," argument) ")"
 workbook-deleteParams = "(" argument ")"
 workbook-hideParams = "(" argument ["," argument] ")"
 workbook-insertParams = "(" argument ")"
 workbook-moveParams = "(" argument *2("," argument) ")"
 workbook-nameParams = "(" argument ["," argument] ")"
 workbook-newParams = "(" argument *2("," argument) ")"
 workbook-nextParams = "(" *space ")"
 workbook-optionsParams = "(" argument *2("," argument) ")"
 workbook-prevParams = "(" *space ")"
 workbook-protectParams = "(" argument *2("," argument) ")"
 workbook-scrollParams = "(" argument ["," argument] ")"
 workbook-selectParams = "(" argument *2("," argument) ")"
 workbook-tab-splitParams = "(" argument ")"
 workbook-unhideParams = "(" argument ")"
 workgroupParams = "(" argument ")"
 workgroup-optionsParams = "(" *space ")"
 workspaceParams = "(" argument *15("," argument) ")"
 zoomParams = "(" argument ")"